Poll,Date,Year_S,Year_E,Sample,Approve,Disapprove,Spread
FOX News,1/15 - 1/18,2017,2017,1006 RV,57,39,18
Gallup,1/15 - 1/18,2017,2017,1500 A,58,38,20
Economist/YouGov,1/14 - 1/17,2017,2017,1078 RV,54,42,12
Reuters/Ipsos,1/13 - 1/17,2017,2017,2070 A,56,41,15
CBS News,1/13 - 1/16,2017,2017,1257 A,62,36,26
Rasmussen Reports,1/12 - 1/16,2017,2017,1500 LV,62,38,24
ABC News/Wash Post,1/12 - 1/15,2017,2017,1005 A,60,38,22
CNN/ORC,1/12 - 1/15,2017,2017,1000 A,60,39,21
NBC News/Wall St. Jrnl,1/12 - 1/15,2017,2017,1000 A,56,40,16
Monmouth,1/12 - 1/15,2017,2017,708 RV,54,40,14
Economist/YouGov,1/7 - 1/10,2017,2017,1069 RV,51,46,5
Reuters/Ipsos,1/6 - 1/10,2017,2017,1787 A,52,44,8
Quinnipiac,1/5 - 1/9,2017,2017,899 RV,55,39,16
Pew Research,1/4 - 1/9,2017,2017,1502 A,55,40,15
IBD/TIPP,1/3 - 1/9,2017,2017,904 A,55,41,14
Economist/YouGov,12/31 - 1/3,2016,2017,1234 RV,51,43,8
Reuters/Ipsos,12/30 - 1/3,2016,2017,1961 A,52,44,8
Economist/YouGov,12/24 - 12/27,2016,2016,1196 RV,51,44,7
Economist/YouGov,12/17 - 12/20,2016,2016,998 RV,50,44,6
Reuters/Ipsos,12/16 - 12/20,2016,2016,2065 A,56,41,15
USA Today/Suffolk,12/14 - 12/18,2016,2016,1000 RV,54,41,13
NBC News/Wall St. Jrnl,12/12 - 12/15,2016,2016,1000 A,52,42,10
FOX News,12/11 - 12/13,2016,2016,1034 RV,53,41,12
Economist/YouGov,12/10 - 12/13,2016,2016,1051 RV,51,45,6
Reuters/Ipsos,12/9 - 12/13,2016,2016,1208 A,54,41,13
CBS News,12/9 - 12/13,2016,2016,1259 A,56,36,20
PPP (D),12/6 - 12/7,2016,2016,1224 RV,50,45,5
McClatchy/Marist,12/1 - 12/9,2016,2016,873 RV,55,42,13
Reuters/Ipsos,12/2 - 12/6,2016,2016,1716 A,53,42,11
Economist/YouGov,12/3 - 12/5,2016,2016,977 RV,52,45,7
Bloomberg,12/2 - 12/5,2016,2016,999 A,54,42,12
Pew Research,11/30 - 12/5,2016,2016,1502 A,58,37,21
IBD/TIPP,11/28 - 12/4,2016,2016,902 A,55,40,15
GWU/Battleground,11/28 - 12/1,2016,2016,1000 RV,53,42,11
Economist/YouGov,11/28 - 11/29,2016,2016,1079 RV,52,45,7
Reuters/Ipsos,11/25 - 11/29,2016,2016,1704 A,53,42,11
Economist/YouGov,11/19 - 11/22,2016,2016,1002 RV,55,41,14
Reuters/Ipsos,11/18 - 11/22,2016,2016,1645 A,53,40,13
Quinnipiac,11/17 - 11/20,2016,2016,1071 RV,50,43,7
CNN/ORC,11/17 - 11/20,2016,2016,1003 A,57,41,16
The Atlantic,11/16 - 11/21,2016,2016,1000 A,56,40,16
Economist/YouGov,11/12 - 11/15,2016,2016,1345 RV,51,45,6
Reuters/Ipsos,11/11 - 11/15,2016,2016,1761 A,50,44,6
Washington Post,11/11 - 11/14,2016,2016,1002 A,56,40,16
Economist/YouGov,11/4 - 11/7,2016,2016,3677 LV,50,49,1
FOX News,11/3 - 11/6,2016,2016,1295 LV,52,47,5
NBC News/Wall St. Jrnl,11/3 - 11/5,2016,2016,1282 LV,53,44,9
McClatchy/Marist,11/1 - 11/3,2016,2016,940 LV,51,45,6
Reuters/Ipsos,10/29 - 11/2,2016,2016,2708 A,51,45,6
CBS News/NY Times,10/28 - 11/1,2016,2016,1561 A,54,40,14
Economist/YouGov,10/30 - 11/1,2016,2016,1233 LV,49,49,Tie
Economist/YouGov,10/22 - 10/26,2016,2016,1209 LV,48,51,-3
FOX News,10/22 - 10/25,2016,2016,1221 LV,53,46,7
Pew Research,10/20 - 10/25,2016,2016,2583 A,54,42,12
USA Today/Suffolk,10/20 - 10/24,2016,2016,1000 LV,54,41,13
Associated Press-GfK,10/20 - 10/24,2016,2016,1212 LV,53,47,6
Reuters/Ipsos,10/20 - 10/24,2016,2016,1777 A,48,47,1
CNN/ORC,10/20 - 10/23,2016,2016,1017 A,55,43,12
Economist/YouGov,10/15 - 10/18,2016,2016,925 RV,50,48,2
FOX News,10/15 - 10/17,2016,2016,912 LV,50,46,4
Bloomberg,10/14 - 10/17,2016,2016,1006 LV,51,44,7
Reuters/Ipsos,10/13 - 10/17,2016,2016,1750 A,51,45,6
NBC News/Wall St. Jrnl,10/10 - 10/13,2016,2016,1000 RV,53,44,9
FOX News,10/10 - 10/12,2016,2016,917 LV,57,41,16
GWU/Battleground,10/8 - 10/13,2016,2016,1000 LV,53,44,9
Economist/YouGov,10/7 - 10/8,2016,2016,971 RV,49,49,Tie
Reuters/Ipsos,10/6 - 10/10,2016,2016,3567 A,52,44,8
FOX News,10/3 - 10/6,2016,2016,896 LV,51,48,3
Economist/YouGov,10/1 - 10/3,2016,2016,911 RV,49,49,Tie
Reuters/Ipsos,9/29 - 10/3,2016,2016,1928 A,51,45,6
CNN/ORC,9/28 - 10/2,2016,2016,1501 A,55,44,11
CBS News,9/28 - 10/2,2016,2016,1217 RV,51,43,8
FOX News,9/27 - 9/29,2016,2016,911 LV,52,46,6
PPP (D),9/27 - 9/28,2016,2016,933 LV,48,48,Tie
Reuters/Ipsos,9/22 - 9/26,2016,2016,1705 A,46,47,-1
Monmouth,9/22 - 9/25,2016,2016,802 RV,53,43,10
Economist/YouGov,9/22 - 9/24,2016,2016,948 RV,50,49,1
Bloomberg,9/21 - 9/24,2016,2016,1002 LV,49,48,1
ABC News/Wash Post,9/19 - 9/22,2016,2016,834 RV,51,45,6
McClatchy/Marist,9/15 - 9/20,2016,2016,758 LV,51,44,7
Economist/YouGov,9/18 - 9/19,2016,2016,936 RV,47,51,-4
NBC News/Wall St. Jrnl,9/16 - 9/19,2016,2016,1000 RV,52,45,7
Reuters/Ipsos,9/15 - 9/19,2016,2016,1749 A,47,48,-1
Associated Press-GfK,9/15 - 9/16,2016,2016,1251 LV,50,50,-
FOX News,9/11 - 9/14,2016,2016,867 LV,50,48,2
Economist/YouGov,9/10 - 9/13,2016,2016,926 RV,48,50,-2
Quinnipiac,9/8 - 9/13,2016,2016,960 LV,50,47,3
Reuters/Ipsos,9/8 - 9/12,2016,2016,1752 A,48,48,-
ABC News/Wash Post,9/5 - 9/8,2016,2016,842 RV,55,42,13
Economist/YouGov,9/4 - 9/6,2016,2016,955 RV,50,48,2
ABC News/Wash Post,11/11 - 11/14,2016,2016,1002 A,56,40,16
Reuters/Ipsos,9/1 - 9/5,2016,2016,1760 A,47,48,-1
CNN/ORC,9/1 - 9/4,2016,2016,1001 A,51,48,3
GWU/Battleground,8/28 - 9/1,2016,2016,1000 LV,51,47,4
IBD/TIPP,8/26 - 9/1,2016,2016,934 A,50,44,6
FOX News,8/28 - 8/30,2016,2016,1011 RV,54,43,11
Economist/YouGov,8/27 - 8/29,2016,2016,942 RV,48,49,-1
PPP (D),8/26 - 8/28,2016,2016,881 LV,50,46,4
USA Today/Suffolk,8/24 - 8/29,2016,2016,1000 LV,50,45,5
Reuters/Ipsos,8/25 - 8/29,2016,2016,1946 A,47,48,-1
Reuters/Ipsos,8/20 - 8/24,2016,2016,1516 A,44,50,-6
Quinnipiac,8/18 - 8/24,2016,2016,1498 LV,54,44,10
Economist/YouGov,8/19 - 8/23,2016,2016,906 RV,47,52,-5
Reuters/Ipsos,8/13 - 8/17,2016,2016,1607 A,46,48,-2
Economist/YouGov,8/14 - 8/16,2016,2016,916 RV,49,50,-1
Pew Research,8/9 - 8/16,2016,2016,2010 A,53,42,11
Reuters/Ipsos,8/6 - 8/10,2016,2016,1459 A,50,45,5
Economist/YouGov,8/6 - 8/9,2016,2016,911 RV,49,49,-
Bloomberg,8/5 - 8/8,2016,2016,1007 A,50,44,6
Monmouth,8/4 - 8/7,2016,2016,683 LV,56,40,16
ABC News/Wash Post,8/1 - 8/4,2016,2016,815 RV,53,45,8
McClatchy/Marist,8/1 - 8/3,2016,2016,983 RV,53,40,13
NBC News/Wall St. Jrnl,7/31 - 8/3,2016,2016,800 RV,52,44,8
FOX News,7/31 - 8/2,2016,2016,1022 RV,52,45,7
IBD/TIPP,7/29 - 8/4,2016,2016,921 A,52,40,12
Reuters/Ipsos,7/30 - 8/3,2016,2016,1631 A,48,48,-
Economist/YouGov,7/30 - 8/1,2016,2016,933 RV,48,49,-1
CNN/ORC,7/29 - 7/31,2016,2016,1003 A,54,45,9
PPP (D),7/29 - 7/30,2016,2016,1276 LV,50,47,3
Reuters/Ipsos,7/25 - 7/29,2016,2016,2157 A,45,49,-4
Economist/YouGov,7/23 - 7/24,2016,2016,1057 RV,48,49,-1
CNN/ORC,7/22 - 7/24,2016,2016,1001 A,50,47,3
Reuters/Ipsos,7/16 - 7/20,2016,2016,1522 A,44,49,-5
Economist/YouGov,7/15 - 7/17,2016,2016,925 RV,45,49,-4
Monmouth,7/14 - 7/16,2016,2016,688 LV,49,47,2
ABC News/Wash Post,7/11 - 7/14,2016,2016,816 RV,52,46,6
NBC News/Wall St. Jrnl,7/9 - 7/13,2016,2016,1000 RV,51,46,5
CBS News/NY Times,7/8 - 7/12,2016,2016,1600 A,53,41,12
Economist/YouGov,7/9 - 7/11,2016,2016,932 RV,46,51,-5
Associated Press-GfK,7/7 - 7/11,2016,2016,1009 A,47,52,-5
McClatchy/Marist,7/5 - 7/9,2016,2016,1053 RV,51,43,8
Reuters/Ipsos,7/2 - 7/6,2016,2016,1543 A,51,45,6
Economist/YouGov,7/2 - 7/4,2016,2016,918 RV,45,51,-6
USA Today/Suffolk,6/26 - 6/29,2016,2016,1000 LV,50,47,3
PPP (D),6/27 - 6/28,2016,2016,947 RV,48,47,1
FOX News,6/26 - 6/28,2016,2016,1017 RV,50,47,3
IBD/TIPP,6/24 - 6/29,2016,2016,905 A,50,45,5
Reuters/Ipsos,6/25 - 6/29,2016,2016,1543 A,49,46,3
Economist/YouGov,6/24 - 6/27,2016,2016,919 RV,43,54,-11
Quinnipiac,6/21 - 6/27,2016,2016,1610 RV,48,48,-
The Atlantic,6/19 - 6/24,2016,2016,1000 A,51,43,8
ABC News/Wash Post,6/20 - 6/23,2016,2016,836 RV,54,43,11
NBC News/Wall St. Jrnl,6/19 - 6/23,2016,2016,1000 RV,51,45,6
Pew Research,6/15 - 6/26,2016,2016,2245 A,50,44,6
Reuters/Ipsos,6/18 - 6/20,2016,2016,1585 A,50,46,4
Economist/YouGov,6/18 - 6/20,2016,2016,911 RV,47,49,-2
CNN/ORC,6/16 - 6/19,2016,2016,1001 A,52,45,7
Monmouth,6/15 - 6/19,2016,2016,803 RV,49,46,3
Reuters/Ipsos,6/11 - 6/15,2016,2016,1602 A,48,47,1
Bloomberg,6/10 - 6/13,2016,2016,1000 A,53,42,11
CBS News,6/9 - 6/13,2016,2016,1280 A,53,41,12
FOX News,6/5 - 6/8,2016,2016,1004 RV,51,46,5
Reuters/Ipsos,6/4 - 6/8,2016,2016,1716 A,49,47,2
Economist/YouGov,6/2 - 6/5,2016,2016,1396 RV,46,52,-6
IBD/TIPP,5/31 - 6/5,2016,2016,908 A,51,42,9
Reuters/Ipsos,5/28 - 6/1,2016,2016,1615 A,52,44,8
Quinnipiac,5/24 - 5/30,2016,2016,1561 RV,49,48,1
Reuters/Ipsos,5/21 - 5/25,2016,2016,1576 A,47,46,1
The Economist/YouGov,5/20 - 5/23,2016,2016,1393 RV,45,52,-7
ABC News/Wash Post,5/16 - 5/19,2016,2016,829 RV,47,51,-4
NBC News/Wall St. Jrnl,5/15 - 5/19,2016,2016,1000 RV,51,46,5
FOX News,5/14 - 5/17,2016,2016,1021 RV,48,49,-1
Reuters/Ipsos,5/14 - 5/17,2016,2016,1677 A,48,47,1
CBS News/NY Times,5/13 - 5/17,2016,2016,1300 A,50,43,7
Reuters/Ipsos,5/7 - 5/11,2016,2016,1611 A,47,50,-3
The Economist/YouGov,5/6 - 5/9,2016,2016,1389 RV,46,52,-6
PPP (D),5/6 - 5/9,2016,2016,1222 RV,49,48,1
Reuters/Ipsos,4/30 - 5/4,2016,2016,1277 A,49,45,4
CNN/ORC,4/28 - 5/1,2016,2016,1001 A,51,46,5
IBD/TIPP,4/22 - 4/28,2016,2016,903 A,49,44,5
Reuters/Ipsos,4/23 - 4/27,2016,2016,2116 A,46,49,-3
The Economist/YouGov,4/22 - 4/26,2016,2016,1375 RV,45,51,-6
USA Today/Suffolk,4/20 - 4/24,2016,2016,1000 LV,46,45,1
GWU/Battleground,4/17 - 4/20,2016,2016,1000 LV,51,46,5
Pew Research,4/12 - 4/19,2016,2016,2008 A,48,47,1
Reuters/Ipsos,4/16 - 4/20,2016,2016,1598 A,49,45,4
NBC News/Wall St. Jrnl,4/10 - 4/14,2016,2016,1000 RV,49,48,1
FOX News,4/11 - 4/13,2016,2016,1021 RV,49,47,2
Reuters/Ipsos,4/9 - 4/13,2016,2016,1680 A,48,48,-
CBS News,4/8 - 4/12,2016,2016,1320 A,46,45,1
The Economist/YouGov,4/8 - 4/11,2016,2016,1392 RV,45,53,-8
Reuters/Ipsos,4/2 - 4/6,2016,2016,1526 A,46,50,-4
Associated Press-GfK,3/31 - 4/4,2016,2016,1076 A,50,50,-
IBD/TIPP,3/28 - 4/2,2016,2016,902 A,48,44,4
McClatchy/Marist,3/29 - 3/31,2016,2016,1066 RV,50,46,4
Reuters/Ipsos,3/27 - 3/31,2016,2016,1858 A,46,49,-3
The Economist/YouGov,3/26 - 3/29,2016,2016,1384 RV,46,51,-5
PPP (D),3/24 - 3/26,2016,2016,1083 RV,47,48,-1
Pew Research,3/17 - 3/27,2016,2016,2254 A,51,44,7
FOX News,3/20 - 3/22,2016,2016,1016 RV,48,46,2
Reuters/Ipsos,3/19 - 3/23,2016,2016,1565 A,45,50,-5
Bloomberg,3/19 - 3/22,2016,2016,1000 A,50,44,6
Quinnipiac,3/16 - 3/21,2016,2016,1451 RV,49,48,1
CNN/ORC,3/17 - 3/20,2016,2016,1001 A,51,46,5
CBS News/NY Times,3/17 - 3/20,2016,2016,1252 A,48,44,4
Monmouth,3/17 - 3/20,2016,2016,848 RV,48,45,3
Reuters/Ipsos,3/12 - 3/16,2016,2016,1684 A,46,51,-5
The Economist/YouGov,3/10 - 3/12,2016,2016,1324 RV,44,54,-10
Reuters/Ipsos,3/5 - 3/9,2016,2016,1867 A,45,49,-4
NBC News/Wall St. Jrnl,3/3 - 3/6,2016,2016,1200 RV,49,46,3
ABC News/Wash Post,3/3 - 3/6,2016,2016,1000 A,51,43,8
Reuters/Ipsos,2/27 - 3/2,2016,2016,1587 A,47,47,-
The Economist/YouGov,2/24 - 2/27,2016,2016,1253 RV,44,54,-10
CNN/ORC,2/24 - 2/27,2016,2016,1001 A,50,46,4
Reuters/Ipsos,2/20 - 2/24,2016,2016,1497 A,47,48,-1
IBD/TIPP,2/19 - 2/24,2016,2016,900 A,46,47,-1
FOX News,2/15 - 2/17,2016,2016,429 LV,49,47,2
NBC News/Wall St. Jrnl,2/14 - 2/16,2016,2016,800 RV,49,47,2
Reuters/Ipsos,2/13 - 2/17,2016,2016,1473 A,45,51,-6
Associated Press-GfK,2/11 - 2/15,2016,2016,1033 A,44,55,-11
The Economist/YouGov,2/11 - 2/15,2016,2016,1240 RV,43,55,-12
CBS News,2/12 - 2/16,2016,2016,2007 A,47,45,2
USA Today/Suffolk,2/11 - 2/15,2016,2016,1000 LV,40,51,-11
Quinnipiac,2/10 - 2/15,2016,2016,1342 RV,44,54,-10
Reuters/Ipsos,2/6 - 2/10,2016,2016,1590 A,45,52,-7
PPP (D),2/2 - 2/3,2016,2016,1236 RV,45,51,-6
Reuters/Ipsos,1/30 - 2/3,2016,2016,1685 A,46,49,-3
The Economist/YouGov,1/27 - 1/30,2016,2016,1260 RV,42,56,-14
IBD/TIPP,1/22 - 1/27,2016,2016,914 A,49,43,6
CNN/ORC,1/21 - 1/24,2016,2016,1002 A,47,49,-2
ABC News/Wash Post,1/21 - 1/24,2016,2016,1001 A,50,46,4
FOX News,1/18 - 1/21,2016,2016,1009 RV,45,48,-3
Reuters/Ipsos,1/16 - 1/20,2016,2016,1561 A,45,51,-6
The Economist/YouGov,1/15 - 1/19,2016,2016,1243 RV,43,55,-12
Monmouth,1/15 - 1/18,2016,2016,872 RV,45,48,-3
NBC News/Wall St. Jrnl,1/9 - 1/13,2016,2016,800 RV,47,49,-2
Pew Research,1/7 - 1/14,2016,2016,2009 A,46,48,-2
Reuters/Ipsos,1/9 - 1/13,2016,2016,1602 A,48,48,-
CBS/NY Times,1/7 - 1/10,2016,2016,1276 A,46,47,-1
IBD/TIPP,1/4 - 1/8,2016,2016,967 A,43,48,-5
FOX News,1/4 - 1/7,2016,2016,1006 RV,42,53,-11
Reuters/Ipsos,1/2 - 1/6,2016,2016,1754 A,44,51,-7
National Journal,1/2 - 1/6,2016,2016,1000 A,47,47,-
The Economist/YouGov,1/1 - 1/5,2016,2016,1209 RV,43,54,-11
Reuters/Ipsos,12/26 - 12/30,2015,2015,2005 A,41,51,-10
Reuters/Ipsos,12/19 - 12/23,2015,2015,1593 A,42,52,-10
The Economist/YouGov,12/18 - 12/22,2015,2015,1214 RV,42,56,-14
CNN/Opinion Research,12/17 - 12/21,2015,2015,1018 A,47,52,-5
Quinnipiac,12/16 - 12/20,2015,2015,1140 RV,44,52,-8
FOX News,12/16 - 12/17,2015,2015,1013 RV,43,51,-8
PPP (D),12/16 - 12/17,2015,2015,1267 RV,44,48,-4
Reuters/Ipsos,12/12 - 12/16,2015,2015,1978 A,42,53,-11
Monmouth,12/10 - 12/13,2015,2015,856 RV,40,54,-14
Pew Research,12/8 - 12/13,2015,2015,1500 A,46,49,-3
NBC News/Wall St. Jrnl,12/6 - 12/9,2015,2015,1000 A,43,51,-8
Reuters/Ipsos,12/5 - 12/9,2015,2015,1416 A,41,53,-12
The Economist/YouGov,12/4 - 12/8,2015,2015,1202 RV,42,56,-14
CBS/NY Times,12/4 - 12/8,2015,2015,1275 A,44,48,-4
USA Today/Suffolk,12/2 - 12/6,2015,2015,1000 LV,44,50,-6
Reuters/Ipsos,11/28 - 12/2,2015,2015,1072 A,44,50,-6
CNN/Opinion Research,11/27 - 12/1,2015,2015,1020 A,45,53,-8
Quinnipiac,11/23 - 11/30,2015,2015,1453 RV,44,51,-7
Reuters/Ipsos,11/21 - 11/25,2015,2015,964 A,42,53,-11
CBS News,11/19 - 11/22,2015,2015,1205 A,42,47,-5
The Economist/YouGov,11/19 - 11/23,2015,2015,1217 RV,44,53,-9
FOX News,11/16 - 11/19,2015,2015,1016 RV,40,54,-14
ABC News/Wash Post,11/16 - 11/19,2015,2015,831 RV,44,53,-9
PPP (D),11/16 - 11/17,2015,2015,1360 RV,43,52,-9
Reuters/Ipsos,11/14 - 11/18,2015,2015,3418 A,42,51,-9
Bloomberg,11/15 - 11/16,2015,2015,1002 A,44,51,-7
Reuters/Ipsos,11/7 - 11/11,2015,2015,1586 A,43,50,-7
CBS News/NYT,11/6 - 11/10,2015,2015,1495 A,45,48,-3
The Economist/YouGov,11/5 - 11/9,2015,2015,1226 RV,45,53,-8
FOX News,11/1 - 11/3,2015,2015,1230 RV,45,50,-5
Reuters/Ipsos,10/31 - 11/4,2015,2015,1636 A,42,52,-10
McClatchy/Marist,10/29 - 11/4,2015,2015,1080 RV,48,48,-
Quinnipiac,10/29 - 11/2,2015,2015,1144 RV,42,54,-12
NBC News/Wall St. Jrnl,10/25 - 10/29,2015,2015,1000 A,45,49,-4
Reuters/Ipsos,10/24 - 10/28,2015,2015,1678 A,43,50,-7
The Economist/YouGov,10/23 - 10/27,2015,2015,1234 RV,42,56,-14
Reuters/Ipsos,10/17 - 10/21,2015,2015,2214 A,42,51,-9
Associated Press-GfK,10/15 - 10/19,2015,2015,1027 A,46,54,-8
NBC News/Wall St. Jrnl,10/15 - 10/18,2015,2015,1000 A,46,49,-3
Monmouth,10/15 - 10/18,2015,2015,836 RV,44,48,-4
ABC News/Wash Post,10/15 - 10/18,2015,2015,809 RV,48,48,-
CNN/Opinion Research,10/14 - 10/17,2015,2015,1028 A,46,51,-5
FOX News,10/10 - 10/12,2015,2015,1004 RV,42,53,-11
Reuters/Ipsos,10/10 - 10/14,2015,2015,1348 A,45,49,-4
The Economist/YouGov,10/8 - 10/12,2015,2015,1279 RV,44,53,-9
CBS News,10/4 - 10/8,2015,2015,1251 A,45,46,-1
Reuters/Ipsos,10/3 - 10/7,2015,2015,1630 A,40,53,-13
PPP (D),10/1 - 10/4,2015,2015,1338 RV,45,50,-5
Reuters/Ipsos,9/26 - 9/30,2015,2015,1304 A,43,49,-6
The Economist/YouGov,9/25 - 9/29,2015,2015,1364 RV,45,52,-7
USA Today/Suffolk,9/24 - 9/28,2015,2015,1000 LV,47,46,1
Pew Research,9/22 - 9/27,2015,2015,1502 A,46,48,-2
NBC News/Wall St. Jrnl,9/20 - 9/24,2015,2015,1000 A,47,47,-
FOX News,9/20 - 9/22,2015,2015,1013 RV,44,50,-6
Reuters/Ipsos,9/19 - 9/23,2015,2015,1582 A,43,51,-8
Bloomberg,9/18 - 9/21,2015,2015,1001 A,46,47,-1
Quinnipiac,9/17 - 9/21,2015,2015,1574 RV,44,53,-9
CNN/Opinion Research,9/17 - 9/19,2015,2015,1006 A,44,50,-6
Reuters/Ipsos,9/12 - 9/16,2015,2015,1570 A,44,49,-5
The Economist/YouGov,9/11 - 9/15,2015,2015,1345 RV,47,50,-3
National Journal,9/10 - 9/15,2015,2015,1000 A,44,47,-3
ABC News/Wash Post,9/7 - 9/10,2015,2015,821 RV,47,49,-2
USA Today/Suffolk,12/2 - 12/6,2015,2015,1000 LV,46,49,-3
CNN/Opinion Research,9/4 - 9/8,2015,2015,1012 A,45,52,-7
Reuters/Ipsos,9/5 - 9/9,2015,2015,1457 A,47,48,-1
Monmouth,8/31 - 9/3,2015,2015,847 RV,45,51,-6
Reuters/Ipsos,8/29 - 9/2,2015,2015,1598 A,47,47,-
The Economist/YouGov,8/28 - 9/1,2015,2015,1343 RV,44,53,-9
PPP (D),8/28 - 8/30,2015,2015,1254 RV,45,49,-4
Reuters/Ipsos,8/22 - 8/26,2015,2015,1152 A,44,49,-5
Quinnipiac,8/20 - 8/25,2015,2015,1563 RV,45,53,-8
Reuters/Ipsos,8/15 - 8/19,2015,2015,851 A,43,52,-9
The Economist/YouGov,8/15 - 8/17,2015,2015,1340 RV,43,53,-10
CNN/Opinion Research,8/13 - 8/16,2015,2015,1001 A,47,51,-4
FOX News,8/11 - 8/13,2015,2015,1008 RV,42,51,-9
Reuters/Ipsos,8/8 - 8/12,2015,2015,1280 A,45,49,-4
Reuters/Ipsos,8/1 - 8/5,2015,2015,993 A,44,51,-7
FOX News,7/30 - 8/2,2015,2015,1306 RV,46,46,-
CBS News,7/29 - 8/2,2015,2015,1252 A,44,47,-3
NBC News/Wall St. Jrnl,7/26 - 7/30,2015,2015,1000 A,45,50,-5
Reuters/Ipsos,7/25 - 7/29,2015,2015,1046 A,44,51,-7
Quinnipiac,7/23 - 7/28,2015,2015,1644 RV,43,52,-9
McClatchy/Marist,7/22 - 7/28,2015,2015,964 RV,47,47,-
CNN/Opinion Research,7/22 - 7/25,2015,2015,898 RV,48,48,-
PPP (D),7/20 - 7/21,2015,2015,1087 RV,45,49,-4
Reuters/Ipsos,7/18 - 7/22,2015,2015,1046 A,41,52,-11
The Economist/YouGov,7/18 - 7/20,2015,2015,681 RV,46,50,-4
ABC News/Wash Post,7/16 - 7/19,2015,2015,815 RV,45,52,-7
Pew Research,7/14 - 7/20,2015,2015,2002 A,48,45,3
FOX News,7/13 - 7/15,2015,2015,1019 RV,47,48,-1
Associated Press-GfK,7/9 - 7/13,2015,2015,1004 A,43,55,-12
Reuters/Ipsos,7/11 - 7/15,2015,2015,922 A,45,49,-4
USA Today/Suffolk,7/9 - 7/12,2015,2015,1000 LV,44,46,-2
The Economist/YouGov,7/4 - 7/6,2015,2015,663 RV,43,55,-12
Reuters/Ipsos,7/4 - 7/8,2015,2015,1319 A,45,49,-4
Reuters/Ipsos,6/27 - 7/1,2015,2015,1404 A,44,49,-5
The Economist/YouGov,6/27 - 6/29,2015,2015,690 RV,45,53,-8
CNN/Opinion Research,6/26 - 6/28,2015,2015,890 RV,50,48,2
Reuters/Ipsos,6/20 - 6/24,2015,2015,2501 A,46,48,-2
The Economist/YouGov,6/20 - 6/22,2015,2015,696 RV,44,55,-11
FOX News,6/21 - 6/23,2015,2015,1005 RV,44,50,-6
NBC News/Wall St. Jrnl,6/14 - 6/18,2015,2015,1000 A,48,48,-
The Economist/YouGov,6/13 - 6/15,2015,2015,693 RV,42,56,-14
PPP (D),6/11 - 6/14,2015,2015,1129 RV,45,50,-5
The Economist/YouGov,6/6 - 6/8,2015,2015,658 RV,42,55,-13
Reuters/Ipsos,6/6 - 6/10,2015,2015,2949 A,42,52,-10
Reuters/Ipsos,5/30 - 6/3,2015,2015,1638 A,45,48,-3
The Economist/YouGov,5/30 - 6/1,2015,2015,681 RV,46,53,-7
FOX News,5/31 - 6/2,2015,2015,1006 RV,45,48,-3
CNN/Opinion Research,5/29 - 5/31,2015,2015,1025 A,45,52,-7
ABC News/Wash Post,5/28 - 5/31,2015,2015,RV,43,53,-10
CBS News/NY Times,5/28 - 5/31,2015,2015,1022 A,42,48,-6
Reuters/Ipsos,5/23 - 5/27,2015,2015,1695 A,42,50,-8
The Economist/YouGov,5/23 - 5/25,2015,2015,676 RV,46,53,-7
Quinnipiac,5/19 - 5/26,2015,2015,1711 RV,43,50,-7
National Journal,5/17 - 5/27,2015,2015,1000 A,46,46,-
Reuters/Ipsos,5/16 - 5/20,2015,2015,1586 A,43,51,-8
The Economist/YouGov,5/16 - 5/18,2015,2015,690 RV,45,53,-8
Pew Research,5/12 - 5/18,2015,2015,2002 A,46,48,-2
Reuters/Ipsos,5/14 - 5/18,2015,2015,1880 A,42,52,-10
FOX News,5/9 - 5/12,2015,2015,1006 RV,44,51,-7
The Economist/YouGov,5/9 - 5/11,2015,2015,685 RV,47,52,-5
FOX News,8/11 - 8/13,2015,2015,1008 RV,42,51,-9
GWU/Battleground,5/3 - 5/6,2015,2015,1000 RV,45,49,-4
Reuters/Ipsos,5/2 - 5/6,2015,2015,1678 A,44,49,-5
The Economist/YouGov,5/2 - 5/4,2015,2015,695 RV,45,53,-8
CBS News/NY Times,4/30 - 5/3,2015,2015,1027 A,45,44,1
NBC News/Wall St. Jrnl,4/26 - 4/30,2015,2015,1000 A,48,47,1
Reuters/Ipsos,4/25 - 4/29,2015,2015,1758 A,44,49,-5
The Economist/YouGov,4/25 - 4/27,2015,2015,689 RV,49,49,-
Associated Press/GfK,4/23 - 4/27,2015,2015,1077 A,45,55,-10
FOX News,4/19 - 4/21,2015,2015,1012 RV,42,53,-11
Reuters/Ipsos,4/18 - 4/22,2015,2015,1556 A,45,49,-4
The Economist/YouGov,4/18 - 4/20,2015,2015,693 RV,45,52,-7
Quinnipiac,4/16 - 4/21,2015,2015,1353 RV,44,49,-5
CNN/Opinion Research,4/16 - 4/19,2015,2015,1018 A,48,47,1
Reuters/Ipsos,4/11 - 4/15,2015,2015,1632 A,41,51,-10
The Economist/YouGov,4/11 - 4/13,2015,2015,689 RV,48,51,-3
USA Today/Suffolk,4/8 - 4/13,2015,2015,1000 A,42,48,-6
Reuters/Ipsos,5/2 - 5/6,2015,2015,1678 A,44,49,-5
Bloomberg,4/6 - 4/8,2015,2015,1008 A,47,46,1
The Economist/YouGov,4/4 - 4/6,2015,2015,699 RV,47,50,-3
Reuters/Ipsos,3/28 - 4/1,2015,2015,1843 A,41,53,-12
FOX News,3/29 - 3/31,2015,2015,1025 RV,45,50,-5
The Economist/YouGov,3/28 - 3/30,2015,2015,687 RV,44,54,-10
PPP (D),3/26 - 3/31,2015,2015,989 RV,42,53,-11
Pew Research,3/25 - 3/29,2015,2015,1500 A,46,47,-1
ABC News/Wash Post,3/26 - 3/29,2015,2015,RV,46,49,-3
CBS News,3/21 - 3/24,2015,2015,1023 A,45,46,-1
Reuters/Ipsos,3/20 - 3/24,2015,2015,1595 A,43,52,-9
The Economist/YouGov,3/21 - 3/23,2015,2015,696 RV,47,51,-4
Reuters/Ipsos,3/14 - 3/18,2015,2015,1540 A,44,50,-6
The Economist/YouGov,3/14 - 3/16,2015,2015,695 RV,45,52,-7
CNN/Opinion Research,3/13 - 3/15,2015,2015,1009 A,46,51,-5
Reuters/Ipsos,3/6 - 3/10,2015,2015,1504 A,43,51,-8
NBC News/Wall St. Jrnl,3/1 - 3/5,2015,2015,1000 A,46,50,-4
McClatchy/Marist,3/1 - 3/4,2015,2015,1036 RV,46,50,-4
FOX News,3/1 - 3/3,2015,2015,1011 RV,42,53,-11
Reuters/Ipsos,2/28 - 3/4,2015,2015,2611 A,41,52,-11
The Economist/YouGov,2/28 - 3/2,2015,2015,696 RV,47,51,-4
Quinnipiac,2/26 - 3/2,2015,2015,1286 RV,41,52,-11
Reuters/Ipsos,2/21 - 2/25,2015,2015,1599 A,39,55,-16
The Economist/YouGov,2/21 - 2/23,2015,2015,694 RV,46,52,-6
PPP (D),2/20 - 2/22,2015,2015,691 RV,44,50,-6
Pew Research,2/18 - 2/22,2015,2015,1154 RV,44,52,-8
National Journal,2/18 - 2/22,2015,2015,1000 A,46,48,-2
Reuters/Ipsos,2/14 - 2/18,2015,2015,1716 A,42,51,-9
CBS News,2/13 - 2/17,2015,2015,1006 A,44,46,-2
The Economist/YouGov,2/14 - 2/16,2015,2015,687 RV,45,53,-8
CNN/Opinion Research,2/12 - 2/15,2015,2015,1027 A,47,51,-4
Reuters/Ipsos,2/7 - 2/11,2015,2015,1413 A,43,50,-7
FOX News,2/8 - 2/10,2015,2015,1044 RV,45,49,-4
The Economist/YouGov,2/7 - 2/9,2015,2015,663 RV,41,55,-14
Reuters/Ipsos,1/31 - 2/4,2015,2015,2210 A,43,49,-6
The Economist/YouGov,1/31 - 2/2,2015,2015,685 RV,42,55,-13
Associated Press/GfK,1/29 - 2/2,2015,2015,1045 A,47,52,-5
Reason-Rupe/PSRAI,1/29 - 2/2,2015,2015,1003 A,50,44,6
FOX News,1/25 - 1/27,2015,2015,1009 RV,45,51,-6
Reuters/Ipsos,1/24 - 1/28,2015,2015,1611 A,46,50,-4
The Economist/YouGov,1/24 - 1/26,2015,2015,685 RV,44,54,-10
PPP (D),1/22 - 1/25,2015,2015,612 RV,44,49,-5
USA Today/Suffolk,1/21 - 1/24,2015,2015,1000 A,46,48,-2
Reuters/Ipsos,1/17 - 1/21,2015,2015,1529 A,41,52,-11
The Economist/YouGov,1/17 - 1/19,2015,2015,693 RV,45,53,-8
NBC News/Wall St. Jrnl,1/14 - 1/17,2015,2015,800 A,46,48,-2
ABC News/Wash Post,1/12 - 1/15,2015,2015,843 RV,47,48,-1
Reuters/Ipsos,1/10 - 1/14,2015,2015,1714 A,37,55,-18
FOX News,1/11 - 1/13,2015,2015,1018 RV,42,52,-10
CBS News,1/9 - 1/12,2015,2015,1001 A,46,46,-
Pew Research,1/7 - 1/11,2015,2015,1504 A,47,48,-1
Reuters/Ipsos,1/7 - 1/11,2015,2015,1755 A,38,54,-16
The Economist/YouGov,1/3 - 1/5,2015,2015,691 RV,44,54,-10
Reuters/Ipsos,12/31 - 1/4,2014,2015,1817 A,39,55,-16
The Economist/YouGov,12/27 - 12/29,2014,2014,629 RV,45,53,-8
Reuters/Ipsos,12/24 - 12/28,2014,2014,1396 A,41,53,-12
The Economist/YouGov,12/20 - 12/22,2014,2014,701 RV,41,56,-15
Reuters/Ipsos,12/18 - 12/22,2014,2014,1585 A,37,54,-17
CNN/Opinion Research,12/18 - 12/21,2014,2014,1011 A,48,50,-2
The Economist/YouGov,12/13 - 12/15,2014,2014,698 RV,44,54,-10
ABC News/Wash Post,12/11 - 12/14,2014,2014,RV,39,57,-18
NBC News/Wall St. Jrnl,12/10 - 12/14,2014,2014,1000 A,45,50,-5
Reuters/Ipsos,12/10 - 12/14,2014,2014,2096 A,37,54,-17
GWU/Battleground,12/7 - 12/11,2014,2014,1000 LV,43,50,-7
FOX News,12/7 - 12/9,2014,2014,1043 RV,42,53,-11
The Economist/YouGov,12/6 - 12/8,2014,2014,693 RV,42,55,-13
Reuters/Ipsos,12/5 - 12/9,2014,2014,1797 A,37,55,-18
Associated Press/GfK,12/4 - 12/8,2014,2014,1010 A,41,58,-17
McClatchy/Marist,12/3 - 12/9,2014,2014,923 RV,43,52,-9
USA Today/Pew Research,12/3 - 12/7,2014,2014,1507 A,42,51,-9
Bloomberg,12/3 - 12/5,2014,2014,1001 A,39,52,-13
Reuters/Ipsos,11/29 - 12/3,2014,2014,1972 A,40,53,-13
The Economist/YouGov,11/29 - 12/1,2014,2014,687 RV,43,55,-12
Reuters/Ipsos,11/22 - 11/26,2014,2014,1547 A,37,56,-19
The Economist/YouGov,11/22 - 11/24,2014,2014,692 RV,39,58,-19
CNN/Opinion Research,11/21 - 11/23,2014,2014,1045 A,44,53,-9
Quinnipiac,11/18 - 11/23,2014,2014,1623 RV,39,54,-15
The Economist/YouGov,11/15 - 11/17,2014,2014,685 RV,42,56,-14
NBC News/Wall St. Jrnl,11/14 - 11/17,2014,2014,1000 A,44,50,-6
Reuters/Ipsos,11/12 - 11/16,2014,2014,1649 A,38,55,-17
The Economist/YouGov,11/8 - 11/10,2014,2014,696 RV,40,58,-18
Pew Research,11/6 - 11/9,2014,2014,1353 A,43,52,-9
Reuters/Ipsos,11/5 - 11/9,2014,2014,1624 A,36,57,-21
Reuters/Ipsos,11/2 - 11/6,2014,2014,1532 A,37,55,-18
The Economist/YouGov,11/1 - 11/3,2014,2014,707 RV,40,57,-17
NBC News/Wall St. Jrnl,10/30 - 11/1,2014,2014,1200 RV,42,52,-10
FOX News,10/25 - 10/27,2014,2014,734 LV,41,54,-13
Reuters/Ipsos,10/26 - 10/30,2014,2014,1288 A,39,54,-15
The Economist/YouGov,10/25 - 10/27,2014,2014,696 RV,41,57,-16
CBS News,10/23 - 10/27,2014,2014,1269 A,39,51,-12
CNN/Opinion Research,10/24 - 10/26,2014,2014,1018 A,45,53,-8
ABC News/Wash Post,10/23 - 10/26,2014,2014,758 LV,42,56,-14
USA Today/PSRAI,10/23 - 10/26,2014,2014,1210 A,44,50,-6
National Journal,10/22 - 10/26,2014,2014,1000 A,41,49,-8
Reuters/Ipsos,10/18 - 10/22,2014,2014,1760 A,38,56,-18
The Economist/YouGov,10/18 - 10/20,2014,2014,699 RV,41,57,-16
Associated Press/GfK,10/16 - 10/20,2014,2014,968 LV,40,59,-19
Pew Research,10/15 - 10/20,2014,2014,2003 A,43,51,-8
FOX News,10/12 - 10/14,2014,2014,831 LV,39,53,-14
Reuters/Ipsos,10/11 - 10/15,2014,2014,1722 A,39,53,-14
The Economist/YouGov,10/11 - 10/13,2014,2014,710 RV,45,53,-8
ABC News/Wash Post,10/9 - 10/12,2014,2014,629 LV,39,57,-18
NBC News/Wall St. Jrnl,10/8 - 10/12,2014,2014,1000 RV,42,52,-10
Reuters/Ipsos,10/3 - 10/7,2014,2014,1651 A,39,53,-14
CBS News,10/3 - 10/6,2014,2014,1260 A,42,50,-8
The Economist/YouGov,10/4 - 10/6,2014,2014,695 RV,44,52,-8
Reason-Rupe/PSRAI,10/1 - 10/6,2014,2014,1004 A,43,50,-7
Reuters/Ipsos,9/28 - 10/2,2014,2014,1526 A,40,52,-12
FOX News,9/28 - 9/30,2014,2014,845 LV,39,53,-14
The Economist/YouGov,9/27 - 9/29,2014,2014,697 RV,43,55,-12
Associated Press/GfK,9/25 - 9/29,2014,2014,958 LV,42,58,-16
CNN/Opinion Research,9/25 - 9/28,2014,2014,1055 A,44,52,-8
Gallup,9/25 - 9/27,2014,2014,1500 A,42,53,-11
McClatchy/Marist,9/24 - 9/29,2014,2014,884 RV,46,51,-5
Reuters/Ipsos,9/19 - 9/23,2014,2014,1686 A,37,56,-19
The Economist/YouGov,9/20 - 9/22,2014,2014,685 RV,42,56,-14
CBS News/NY Times,9/12 - 9/15,2014,2014,1009 A,40,50,-10
The Economist/YouGov,9/13 - 9/15,2014,2014,690 RV,42,55,-13
Reuters/Ipsos,9/10 - 9/14,2014,2014,1582 A,38,56,-18
FOX News,9/7 - 9/9,2014,2014,833 LV,38,57,-19
The Economist/YouGov,9/6 - 9/8,2014,2014,715 RV,40,58,-18
CNN/Opinion Research,9/5 - 9/7,2014,2014,1014 A,43,55,-12
ABC News/Wash Post,9/4 - 9/7,2014,2014,RV,42,54,-12
Pew Research,9/2 - 9/9,2014,2014,2002 A,42,50,-8
Reuters/Ipsos,9/3 - 9/7,2014,2014,1758 A,39,53,-14
NBC News/Wall St. Jrnl,9/3 - 9/7,2014,2014,1000 RV,40,54,-14
Reuters/Ipsos,8/30 - 9/3,2014,2014,1811 A,38,56,-18
The Economist/YouGov,8/30 - 9/1,2014,2014,729 RV,41,56,-15
GWU/Battleground,8/23 - 8/28,2014,2014,1000 LV,44,51,-7
The Economist/YouGov,8/23 - 8/25,2014,2014,683 RV,43,56,-13
Reuters/Ipsos,8/20 - 8/24,2014,2014,1497 A,38,54,-16
USA Today/Pew Research,8/20 - 8/24,2014,2014,1501 A,42,50,-8
The Economist/YouGov,8/16 - 8/18,2014,2014,709 RV,44,52,-8
Reuters/Ipsos,8/13 - 8/17,2014,2014,1798 A,39,55,-16
FOX News,8/10 - 8/12,2014,2014,1001 RV,42,49,-7
The Economist/YouGov,8/9 - 8/11,2014,2014,732 RV,43,53,-10
Reason-Rupe/PSRAI,8/6 - 8/10,2014,2014,1000 A,43,52,-9
McClatchy/Marist,8/4 - 8/7,2014,2014,806 RV,40,52,-12
Reuters/Ipsos,8/2 - 8/6,2014,2014,1716 A,37,57,-20
The Economist/YouGov,8/2 - 8/4,2014,2014,702 RV,42,54,-12
NBC News/Wall St. Jrnl,7/30 - 8/3,2014,2014,1000 A,40,54,-14
CBS News,7/29 - 8/4,2014,2014,1344 A,41,50,-9
The Economist/YouGov,7/26 - 7/28,2014,2014,699 RV,42,56,-14
Associated Press/GfK,7/24 - 7/28,2014,2014,1044 A,40,59,-19
Reuters/Ipsos,7/20 - 7/24,2014,2014,1640 A,38,58,-20
FOX News,7/20 - 7/22,2014,2014,1057 RV,42,52,-10
CNN/Opinion Research,7/18 - 7/20,2014,2014,1012 A,42,55,-13
The Economist/YouGov,7/19 - 7/21,2014,2014,696 RV,44,54,-10
Reuters/Ipsos,7/12 - 7/16,2014,2014,1689 A,37,56,-19
The Economist/YouGov,7/12 - 7/14,2014,2014,694 RV,42,53,-11
Pew Research,7/8 - 7/14,2014,2014,1805 A,44,49,-5
The Economist/YouGov,7/5 - 7/7,2014,2014,681 RV,42,56,-14
The Economist/YouGov,6/28 - 6/30,2014,2014,700 RV,46,51,-5
Quinnipiac,6/24 - 6/30,2014,2014,1446 RV,40,53,-13
Reuters/Ipsos,6/24 - 6/28,2014,2014,2050 A,37,56,-19
FOX News,6/21 - 6/23,2014,2014,1018 RV,41,54,-13
CBS News/NY Times,6/20 - 6/22,2014,2014,1009 A,40,54,-14
The Economist/YouGov,6/21 - 6/23,2014,2014,670 RV,44,54,-10
Reuters/Ipsos,6/15 - 6/19,2014,2014,1703 A,36,58,-22
The Economist/YouGov,6/14 - 6/16,2014,2014,704 RV,43,55,-12
NBC News/Wall St. Jrnl,6/11 - 6/15,2014,2014,1000 A,41,53,-12
The Economist/YouGov,6/7 - 6/9,2014,2014,692 RV,42,55,-13
Bloomberg,6/6 - 6/9,2014,2014,1005 A,43,53,-10
Reuters/Ipsos,6/1 - 6/5,2014,2014,1596 A,38,55,-17
FOX News,6/1 - 6/3,2014,2014,1006 RV,40,54,-14
CNN/Opinion Research,5/29 - 6/1,2014,2014,1003 A,43,55,-12
ABC News/Wash Post,5/29 - 6/1,2014,2014,RV,45,53,-8
Reuters/Ipsos,5/22 - 5/26,2014,2014,1669 A,38,56,-18
Associated Press/GfK,5/16 - 5/19,2014,2014,1354 A,43,56,-13
CBS News,5/16 - 5/19,2014,2014,1009 A,43,48,-5
FOX News,5/10 - 5/13,2014,2014,1025 RV,44,49,-5
The Economist/YouGov,5/10 - 5/12,2014,2014,674 RV,45,53,-8
Reuters/Ipsos,5/3 - 5/7,2014,2014,1756 A,40,54,-14
CNN/Opinion Research,5/2 - 5/4,2014,2014,1008 A,43,55,-12
The Economist/YouGov,5/3 - 5/5,2014,2014,705 RV,44,53,-9
The Economist/YouGov,4/26 - 4/28,2014,2014,684 RV,45,52,-7
ABC News/Wash Post,4/24 - 4/27,2014,2014,855 RV,41,55,-14
USA Today/Pew Research,4/23 - 4/27,2014,2014,1501 A,44,50,-6
NBC News/Wall St. Jrnl,4/23 - 4/27,2014,2014,1000 A,44,50,-6
The Economist/YouGov,4/19 - 4/21,2014,2014,671 RV,41,56,-15
FOX News,4/13 - 4/15,2014,2014,1012 RV,42,51,-9
Reuters/Ipsos,4/11 - 4/15,2014,2014,1327 RV,44,51,-7
The Economist/YouGov,4/12 - 4/14,2014,2014,704 RV,43,53,-10
National Journal,4/9 - 4/13,2014,2014,1000 A,41,52,-11
McClatchy/Marist,4/7 - 4/10,2014,2014,1036 RV,45,52,-7
The Economist/YouGov,4/5 - 4/7,2014,2014,693 RV,42,55,-13
The Economist/YouGov,3/29 - 3/31,2014,2014,713 RV,42,56,-14
Reason-Rupe/PSRAI,3/26 - 3/30,2014,2014,1003 A,43,51,-8
Quinnipiac,3/26 - 3/31,2014,2014,1578 RV,42,50,-8
FOX News,3/23 - 3/25,2014,2014,1015 RV,40,53,-13
The Economist/YouGov,3/22 - 3/24,2014,2014,711 RV,44,53,-9
Associated Press/GfK,3/20 - 3/24,2014,2014,1012 A,41,59,-18
CBS News,3/20 - 3/23,2014,2014,1097 A,43,50,-7
NPR/GQR/Resurgent,3/19 - 3/23,2014,2014,840 LV,46,51,-5
GWU/Battleground,3/16 - 3/20,2014,2014,1000 LV,44,53,-9
Reuters/Ipsos,3/14 - 3/18,2014,2014,1165 RV,41,55,-14
The Economist/YouGov,3/15 - 3/17,2014,2014,717 RV,42,56,-14
Reuters/Ipsos,3/7 - 3/11,2014,2014,1512 RV,42,53,-11
The Economist/YouGov,3/8 - 3/10,2014,2014,714 RV,42,56,-14
Bloomberg,3/7 - 3/10,2014,2014,1001 A,48,48,-
NBC News/Wall St. Jrnl,3/5 - 3/9,2014,2014,1000 A,41,54,-13
CNN/Opinion Research,3/7 - 3/9,2014,2014,801 A,43,53,-10
PPP (D),3/6 - 3/9,2014,2014,1152 RV,43,51,-8
FOX News,3/2 - 3/4,2014,2014,1002 RV,38,54,-16
The Economist/YouGov,3/1 - 3/3,2014,2014,710 RV,42,55,-13
ABC News/Wash Post,2/27 - 3/2,2014,2014,RV,46,52,-6
The Economist/YouGov,2/22 - 2/24,2014,2014,710 RV,43,55,-12
CBS News/NY Times,2/19 - 2/23,2014,2014,1644 A,41,51,-10
The Economist/YouGov,2/15 - 2/17,2014,2014,723 RV,42,56,-14
FOX News,2/9 - 2/11,2014,2014,1006 RV,42,53,-11
The Economist/YouGov,2/8 - 2/10,2014,2014,716 RV,42,56,-14
McClatchy/Marist,2/4 - 2/9,2014,2014,970 RV,42,52,-10
The Economist/YouGov,2/1 - 2/3,2014,2014,689 RV,44,53,-9
CNN/Opinion Research,1/31 - 2/2,2014,2014,900 RV,45,51,-6
Reuters/Ipsos,1/26 - 1/30,2014,2014,1424 A,40,54,-14
The Economist/YouGov,1/25 - 1/27,2014,2014,714 RV,45,52,-7
NBC News/Wall St. Jrnl,1/22 - 1/25,2014,2014,800 A,43,51,-8
ABC News/Wash Post,1/20 - 1/23,2014,2014,RV,45,52,-7
FOX News,1/19 - 1/21,2014,2014,1010 RV,42,53,-11
Reuters/Ipsos,1/18 - 1/22,2014,2014,1499 A,37,55,-18
The Economist/YouGov,1/18 - 1/20,2014,2014,700 RV,44,54,-10
CBS News,1/17 - 1/21,2014,2014,1018 A,46,47,-1
Associated Press/GfK,1/17 - 1/21,2014,2014,1060 A,45,53,-8
Quinnipiac,1/15 - 1/19,2014,2014,1933 RV,40,54,-14
USA Today/Pew Research,1/15 - 1/19,2014,2014,1504 A,43,49,-6
GWU/Battleground,1/12 - 1/16,2014,2014,1000 LV,41,54,-13
Reuters/Ipsos,1/10 - 1/14,2014,2014,1245 A,40,53,-13
The Economist/YouGov,1/11 - 1/13,2014,2014,696 RV,42,57,-15
Quinnipiac,1/4 - 1/7,2014,2014,1487 RV,41,53,-12
Reuters/Ipsos,1/3 - 1/7,2014,2014,1451 A,39,51,-12
The Economist/YouGov,1/4 - 1/6,2014,2014,698 RV,42,56,-14
The Economist/YouGov,12/28 - 12/30,2013,2013,666 RV,40,57,-17
The Economist/YouGov,12/21 - 12/23,2013,2013,1000 A,42,55,-13
CNN/Opinion Research,12/16 - 12/19,2013,2013,1035 A,41,56,-15
The Economist/YouGov,12/14 - 12/16,2013,2013,1000 A,40,58,-18
FOX News,12/14 - 12/16,2013,2013,1027 RV,41,53,-12
ABC News/Wash Post,12/12 - 12/15,2013,2013,RV,43,55,-12
The Economist/YouGov,12/7 - 12/9,2013,2013,1000 A,41,56,-15
Bloomberg,12/6 - 12/9,2013,2013,1004 A,42,55,-13
Associated Press/GfK,12/5 - 12/9,2013,2013,1367 A,42,58,-16
CBS News/NY Times,12/5 - 12/8,2013,2013,1000 A,42,50,-8
NBC News/Wall St. Jrnl,12/4 - 12/8,2013,2013,1000 A,43,54,-11
Reason-Rupe/PSRAI,12/4 - 12/8,2013,2013,1011 A,47,50,-3
Quinnipiac,12/3 - 12/9,2013,2013,2692 RV,38,57,-19
USA Today/Pew Research,12/3 - 12/8,2013,2013,1579 RV,43,51,-8
McClatchy/Marist,12/3 - 12/5,2013,2013,988 RV,43,53,-10
Reuters/Ipsos,11/29 - 12/3,2013,2013,1494 A,38,55,-17
The Economist/YouGov,11/30 - 12/2,2013,2013,1000 A,39,57,-18
Reuters/Ipsos,11/22 - 11/26,2013,2013,1191 A,38,56,-18
The Economist/YouGov,11/23 - 11/25,2013,2013,1000 A,37,58,-21
CNN/Opinion Research,11/18 - 11/20,2013,2013,RV,41,57,-16
The Economist/YouGov,11/16 - 11/18,2013,2013,649 RV,42,56,-14
CBS News,11/15 - 11/18,2013,2013,1010 A,37,57,-20
ABC News/Wash Post,11/14 - 11/17,2013,2013,RV,41,56,-15
FOX News,11/10 - 11/12,2013,2013,1006 RV,40,55,-15
The Economist/YouGov,11/9 - 11/11,2013,2013,710 RV,44,54,-10
Quinnipiac,11/6 - 11/11,2013,2013,2545 RV,39,54,-15
National Journal,11/2 - 11/6,2013,2013,1000 A,38,55,-17
Pew Research,10/30 - 11/6,2013,2013,1605 RV,39,56,-17
The Economist/YouGov,11/2 - 11/4,2013,2013,686 RV,41,53,-12
GWU/Battleground,10/27 - 10/31,2013,2013,1000 LV,45,52,-7
Reuters/Ipsos,10/25 - 10/29,2013,2013,1660 A,40,52,-12
The Economist/YouGov,10/26 - 10/28,2013,2013,662 RV,44,54,-10
NBC News/Wall St. Jrnl,10/25 - 10/28,2013,2013,800 A,42,51,-9
FOX News,10/20 - 10/22,2013,2013,1020 RV,41,53,-12
The Economist/YouGov,10/19 - 10/21,2013,2013,658 RV,47,50,-3
CBS News,10/18 - 10/21,2013,2013,1007 A,46,49,-3
CNN/Opinion Research,10/18 - 10/20,2013,2013,RV,43,53,-10
ABC News/Wash Post,10/17 - 10/20,2013,2013,RV,46,51,-5
The Economist/YouGov,10/12 - 10/14,2013,2013,691 RV,42,56,-14
Pew Research,10/9 - 10/13,2013,2013,1504 A,43,51,-8
NBC News/Wall St. Jrnl,10/7 - 10/9,2013,2013,800 A,47,48,-1
Democracy Corps (D),10/6 - 10/8,2013,2013,860 LV,47,49,-2
Reuters/Ipsos,10/4 - 10/8,2013,2013,1300 A,40,54,-14
The Economist/YouGov,10/5 - 10/7,2013,2013,716 RV,48,48,-
Associated Press/GfK,10/3 - 10/7,2013,2013,1227 A,37,53,-16
FOX News,10/1 - 10/2,2013,2013,952 RV,45,49,-4
Reuters/Ipsos,9/27 - 10/1,2013,2013,2242 A,41,51,-10
The Economist/YouGov,9/28 - 9/30,2013,2013,723 RV,43,53,-10
CNN/Opinion Research,9/27 - 9/29,2013,2013,803 A,44,53,-9
Quinnipiac,9/23 - 9/29,2013,2013,1497 RV,45,49,-4
Reuters/Ipsos,9/20 - 9/24,2013,2013,1729 A,39,55,-16
The Economist/YouGov,9/21 - 9/23,2013,2013,690 RV,43,55,-12
Bloomberg,9/20 - 9/23,2013,2013,1000 A,45,49,-4
CBS News/NY Times,9/19 - 9/23,2013,2013,1014 A,43,49,-6
The Economist/YouGov,9/14 - 9/16,2013,2013,689 RV,44,55,-11
ABC News/Wash Post,9/12 - 9/15,2013,2013,1004 A,47,47,-
Reuters/Ipsos,9/6 - 9/10,2013,2013,1412 A,39,56,-17
The Economist/YouGov,9/7 - 9/9,2013,2013,699 RV,43,55,-12
McClatchy/Marist,9/7 - 9/8,2013,2013,856 RV,44,47,-3
FOX News,9/6 - 9/8,2013,2013,900 RV,40,54,-14
CBS News/NY Times,9/6 - 9/8,2013,2013,1011 A,46,46,-
CNN/Opinion Research,9/6 - 9/8,2013,2013,1022 A,45,52,-7
NBC News/Wall St. Jrnl,9/5 - 9/8,2013,2013,1000 A,45,50,-5
USA Today/Pew Research,9/4 - 9/8,2013,2013,1201 RV,43,52,-9
Reason-Rupe/PSRAI,9/4 - 9/8,2013,2013,1013 A,43,51,-8
National Journal,9/3 - 9/7,2013,2013,1000 A,40,54,-14
Reuters/Ipsos,8/30 - 9/3,2013,2013,1195 A,41,53,-12
The Economist/YouGov,8/31 - 9/2,2013,2013,691 RV,44,55,-11
NBC News,8/28 - 8/29,2013,2013,700 A,44,48,-4
Reuters/Ipsos,8/23 - 8/27,2013,2013,2293 A,42,52,-10
The Economist/YouGov,8/24 - 8/26,2013,2013,672 RV,41,55,-14
Reuters/Ipsos,8/16 - 8/20,2013,2013,1365 A,41,52,-11
The Economist/YouGov,8/17 - 8/19,2013,2013,734 RV,44,53,-9
Reuters/Ipsos,8/9 - 8/13,2013,2013,1291 A,42,52,-10
The Economist/YouGov,8/10 - 8/12,2013,2013,747 RV,44,53,-9
FOX News,8/3 - 8/5,2013,2013,1007 RV,42,52,-10
The Economist/YouGov,8/3 - 8/5,2013,2013,676 RV,42,57,-15
Quinnipiac,7/28 - 7/31,2013,2013,1468 RV,46,48,-2
Reuters/Ipsos,7/26 - 7/30,2013,2013,1326 A,40,51,-11
The Economist/YouGov,7/27 - 7/29,2013,2013,656 RV,47,52,-5
Monmouth,7/25 - 7/30,2013,2013,850 RV,41,54,-13
FOX News,7/21 - 7/23,2013,2013,1017 RV,46,47,-1
The Economist/YouGov,7/20 - 7/22,2013,2013,726 RV,41,56,-15
Reuters/Ipsos,7/19 - 7/23,2013,2013,2011 A,41,51,-10
CBS News,7/18 - 7/22,2013,2013,1036 A,48,45,3
NBC News/Wall St. Jrnl,7/17 - 7/21,2013,2013,1000 A,45,50,-5
ABC News/Wash Post,7/18 - 7/21,2013,2013,1002 A,49,44,5
Pew Research,7/17 - 7/21,2013,2013,1183 RV,45,50,-5
McClatchy/Marist,7/15 - 7/18,2013,2013,980 RV,41,48,-7
The Economist/YouGov,7/13 - 7/15,2013,2013,712 RV,46,53,-7
Reuters/Ipsos,7/12 - 7/16,2013,2013,1745 A,43,49,-6
Democracy Corps (D),7/10 - 7/15,2013,2013,841 LV,45,51,-6
The Economist/YouGov,7/6 - 7/8,2013,2013,631 RV,43,53,-10
Reuters/Ipsos,7/5 - 7/9,2013,2013,1437 A,45,48,-3
Quinnipiac,6/28 - 7/8,2013,2013,2014 RV,44,48,-4
Reuters/Ipsos,6/28 - 7/2,2013,2013,1430 A,43,51,-8
The Economist/YouGov,6/29 - 7/1,2013,2013,690 RV,45,51,-6
Reuters/Ipsos,6/21 - 6/25,2013,2013,1853 A,43,50,-7
The Economist/YouGov,6/22 - 6/24,2013,2013,685 RV,46,52,-6
FOX News,6/22 - 6/24,2013,2013,1012 RV,43,51,-8
Reuters/Ipsos,6/14 - 6/18,2013,2013,1734 A,44,48,-4
The Economist/YouGov,6/15 - 6/17,2013,2013,684 RV,44,54,-10
Pew Research,6/12 - 6/16,2013,2013,1223 RV,46,48,-2
CNN/Opinion Research,6/11 - 6/13,2013,2013,1014 A,45,54,-9
Time,6/10 - 6/11,2013,2013,805 A,48,44,4
FOX News,6/9 - 6/11,2013,2013,1019 RV,44,50,-6
Reuters/Ipsos,6/7 - 6/11,2013,2013,1037 A,43,51,-8
The Economist/YouGov,6/8 - 6/10,2013,2013,628 RV,46,52,-6
CBS News/NY Times,5/31 - 6/4,2013,2013,1022 A,47,43,4
Reuters/Ipsos,5/31 - 6/4,2013,2013,1183 A,45,50,-5
The Economist/YouGov,6/1 - 6/3,2013,2013,672 RV,48,50,-2
Bloomberg,5/31 - 6/3,2013,2013,1002 A,49,46,3
NBC News/Wall St. Jrnl,5/30 - 6/2,2013,2013,1000 A,48,47,1
National Journal,5/29 - 6/2,2013,2013,1000 A,48,46,2
Reuters/Ipsos,5/24 - 5/28,2013,2013,1985 A,45,50,-5
The Economist/YouGov,5/25 - 5/27,2013,2013,678 RV,47,52,-5
Quinnipiac,5/22 - 5/28,2013,2013,1419 RV,45,49,-4
FOX News,5/18 - 5/20,2013,2013,1013 RV,45,51,-6
The Economist/YouGov,5/18 - 5/20,2013,2013,675 RV,47,52,-5
ABC News/Wash Post,5/16 - 5/19,2013,2013,RV,50,47,3
CNN/Opinion Research,5/17 - 5/18,2013,2013,923 A,53,45,8
Reuters/Ipsos,5/10 - 5/14,2013,2013,1215 A,45,49,-4
The Economist/YouGov,5/11 - 5/13,2013,2013,661 RV,47,50,-3
Reason-Rupe/PSRAI,5/9 - 5/13,2013,2013,1003 A,50,43,7
Reuters/Ipsos,5/3 - 5/7,2013,2013,1589 A,45,47,-2
The Economist/YouGov,5/4 - 5/6,2013,2013,704 RV,49,49,-
Pew Research,5/1 - 5/5,2013,2013,1504 A,51,43,8
Reuters/Ipsos,4/25 - 5/1,2013,2013,943 A,48,49,-1
The Economist/YouGov,4/27 - 4/29,2013,2013,638 RV,50,48,2
Quinnipiac,4/25 - 4/29,2013,2013,1471 RV,48,45,3
CBS News/NY Times,4/24 - 4/28,2013,2013,965 A,47,45,2
FOX News,4/20 - 4/22,2013,2013,1009 RV,47,45,2
Associated Press/GfK,4/11 - 4/15,2013,2013,1004 A,50,47,3
ABC News/Wash Post,4/11 - 4/14,2013,2013,RV,47,49,-2
National Journal,4/5 - 4/9,2013,2013,1000 A,46,49,-3
NBC News/Wall St. Jrnl,4/5 - 4/8,2013,2013,1000 A,47,48,-1
CNN/Opinion Research,4/5 - 4/7,2013,2013,1012 A,51,47,4
Quinnipiac,3/26 - 4/1,2013,2013,1711 RV,49,45,4
McClatchy/Marist,3/25 - 3/27,2013,2013,1061 RV,50,46,4
CBS News,3/20 - 3/24,2013,2013,1181 A,45,46,-1
FOX News,3/17 - 3/19,2013,2013,1002 RV,47,47,-
CNN/Opinion Research,3/15 - 3/17,2013,2013,1021 A,47,50,-3
Pew Research,3/13 - 3/17,2013,2013,1501 A,47,46,1
Democracy Corps (D),3/9 - 3/12,2013,2013,840 LV,48,49,-1
ABC News/Wash Post,3/7 - 3/10,2013,2013,RV,51,46,5
McClatchy/Marist,3/4 - 3/7,2013,2013,1068 RV,45,48,-3
Quinnipiac,2/27 - 3/4,2013,2013,1944 RV,45,46,-1
FOX News,2/25 - 2/27,2013,2013,1010 RV,46,47,-1
Reason-Rupe/PSRAI,2/21 - 2/25,2013,2013,1002 A,51,43,8
NBC News/Wall St. Jrnl,2/21 - 2/24,2013,2013,1000 A,50,45,5
Bloomberg,2/15 - 2/18,2013,2013,1003 A,55,40,15
USA Today/Pew Research,2/13 - 2/18,2013,2013,1504 A,51,41,10
CBS News,2/6 - 2/10,2013,2013,1148 A,52,38,14
FOX News,2/4 - 2/6,2013,2013,1010 RV,49,45,4
Quinnipiac,1/30 - 2/4,2013,2013,1772 RV,46,45,1
Reason-Rupe/PSRAI,1/17 - 1/21,2013,2013,1000 A,52,42,10
FOX News,1/15 - 1/17,2013,2013,1008 RV,47,47,-
CNN/Time,1/14 - 1/15,2013,2013,814 A,55,43,12
NBC News/Wall St. Jrnl,1/12 - 1/15,2013,2013,1000 A,52,44,8
CBS News/NY Times,1/11 - 1/15,2013,2013,1110 A,51,41,10
Democracy Corps (D),1/10 - 1/14,2013,2013,852 LV,53,45,8
Associated Press/GfK,1/10 - 1/14,2013,2013,1004 A,54,42,12
ABC News/Wash Post,1/10 - 1/13,2013,2013,RV,53,43,10
Pew Research,1/9 - 1/13,2013,2013,1502 A,52,40,12
CNN/Opinion Research,12/17 - 12/18,2012,2012,RV,50,45,5
ABC News/Wash Post,12/13 - 12/16,2012,2012,RV,55,42,13
CBS News,12/12 - 12/16,2012,2012,1179 A,57,37,20
FOX News,12/9 - 12/11,2012,2012,1012 RV,48,46,2
Bloomberg,12/7 - 12/10,2012,2012,1000 A,53,44,9
NBC News/Wall St. Jrnl,12/6 - 12/9,2012,2012,1000 A,53,43,10
Pew Research,12/5 - 12/9,2012,2012,1503 A,55,39,16
McClatchy/Marist,12/4 - 12/6,2012,2012,1091 RV,50,44,6
Politico/GWU/Battleground,12/2 - 12/6,2012,2012,1000 LV,50,47,3
Associated Press/GfK,11/29 - 12/3,2012,2012,1002 A,57,41,16
Quinnipiac,11/28 - 12/3,2012,2012,1949 RV,53,40,13
National Journal,11/25 - 12/1,2012,2012,1000 A,54,42,12
CNN/Opinion Research,11/16 - 11/18,2012,2012,RV,52,45,7
Politico/GWU/Battleground,11/4 - 11/5,2012,2012,1000 LV,49,49,-
CNN/Opinion Research,11/2 - 11/4,2012,2012,918 RV,51,47,4
ABC News/Wash Post,11/1 - 11/4,2012,2012,2345 LV,51,48,3
NBC News/Wall St. Jrnl,11/1 - 11/3,2012,2012,1475 LV,49,49,-
Politico/GWU/Battleground,10/29 - 11/1,2012,2012,1000 LV,49,49,-
FOX News,10/28 - 10/30,2012,2012,1128 LV,50,47,3
CBS News/NY Times,10/25 - 10/28,2012,2012,898 A,50,42,8
NPR,10/23 - 10/25,2012,2012,1000 LV,49,49,-
Politico/GWU/Battleground,10/22 - 10/25,2012,2012,1000 LV,50,49,1
Associated Press/GfK,10/19 - 10/23,2012,2012,839 LV,49,49,-
NBC News/Wall St. Jrnl,10/17 - 10/20,2012,2012,1000 RV,49,48,1
CBS News,10/17 - 10/20,2012,2012,1383 A,49,42,7
Politico/GWU/Battleground,10/15 - 10/18,2012,2012,1000 LV,49,48,1
ABC News/Wash Post,10/10 - 10/13,2012,2012,923 LV,50,48,2
Politico/GWU/Battleground,10/7 - 10/11,2012,2012,1000 LV,50,48,2
FOX News,10/7 - 10/9,2012,2012,1109 LV,49,48,1
Politico/GWU/Battleground,10/1 - 10/4,2012,2012,1000 LV,50,48,2
CNN/Opinion Research,9/28 - 9/30,2012,2012,883 RV,50,49,1
NBC News/Wall St. Jrnl,9/26 - 9/30,2012,2012,1000 RV,49,48,1
NPR,9/26 - 9/30,2012,2012,800 LV,50,46,4
Quinnipiac,9/25 - 9/30,2012,2012,1912 LV,48,49,-1
ABC News/Wash Post,9/26 - 9/29,2012,2012,929 RV,49,49,-
Politico/GWU/Battleground,9/24 - 9/27,2012,2012,1000 LV,49,49,-
FOX News,9/24 - 9/26,2012,2012,1092 LV,49,48,1
Bloomberg,9/21 - 9/24,2012,2012,1007 A,49,46,3
Politico/GWU/Battleground,9/16 - 9/20,2012,2012,1000 LV,50,48,2
National Journal,9/15 - 9/19,2012,2012,1250 A,49,45,4
Associated Press/GfK,9/13 - 9/17,2012,2012,807 LV,52,47,5
Reason-Rupe/PSRAI,9/13 - 9/17,2012,2012,787 LV,51,46,5
NBC News/Wall St. Jrnl,9/12 - 9/16,2012,2012,900 RV,50,48,2
FOX News,9/9 - 9/11,2012,2012,1056 LV,50,47,3
CBS News/NY Times,9/8 - 9/12,2012,2012,1162 LV,49,46,3
Democracy Corps (D),9/8 - 9/12,2012,2012,1000 LV,49,48,1
Reuters/Ipsos,9/7 - 9/10,2012,2012,1089 A,50,46,4
ABC News/Wash Post,9/7 - 9/9,2012,2012,826 RV,48,50,-2
CNN/Opinion Research,9/7 - 9/9,2012,2012,875 RV,51,46,5
CNN/Opinion Research,8/31 - 9/3,2012,2012,877 RV,50,46,4
Democracy Corps (D),8/23 - 8/27,2012,2012,1000 LV,47,50,-3
ABC News/Wash Post,8/22 - 8/25,2012,2012,857 RV,47,50,-3
CNN/Opinion Research,8/22 - 8/23,2012,2012,924 RV,50,47,3
FOX News,8/19 - 8/21,2012,2012,1219 RV,46,48,-2
Resurgent Republic (R),8/16 - 8/22,2012,2012,1000 LV,49,49,-
Associated Press/GfK,8/16 - 8/20,2012,2012,1006 A,49,49,-
NBC News/Wall St. Jrnl,8/16 - 8/20,2012,2012,1000 RV,48,49,-1
LA Times/USC,8/13 - 8/19,2012,2012,954 LV,48,47,1
CNN/Opinion Research,8/7 - 8/8,2012,2012,911 RV,49,48,1
Politico/GWU/Battleground,8/5 - 8/9,2012,2012,1000 LV,49,50,-1
FOX News,8/5 - 8/7,2012,2012,930 RV,49,46,3
Reuters/Ipsos,8/2 - 8/6,2012,2012,1168 A,49,48,1
Democracy Corps (D),7/21 - 7/25,2012,2012,700 LV,50,46,4
NBC News/Wall St. Jrnl,7/18 - 7/22,2012,2012,1000 RV,49,48,1
FOX News,7/15 - 7/17,2012,2012,901 RV,47,49,-2
CBS News/NY Times,7/11 - 7/16,2012,2012,1089 A,44,46,-2
NPR,7/9 - 7/12,2012,2012,1000 LV,49,46,3
McClatchy/Marist,7/9 - 7/11,2012,2012,849 RV,47,47,-
Reuters/Ipsos,7/5 - 7/9,2012,2012,1154 A,48,47,1
ABC News/Wash Post,7/5 - 7/8,2012,2012,1003 A,47,49,-2
Quinnipiac,7/1 - 7/8,2012,2012,2722 RV,45,49,-4
Pew Research,6/28 - 7/9,2012,2012,2973 A,50,43,7
CNN/Opinion Research,6/28 - 7/1,2012,2012,1390 RV,50,49,1
Newsweek/Daily Beast,6/28 - 6/28,2012,2012,600 LV,45,54,-9
FOX News,6/24 - 6/26,2012,2012,912 RV,48,43,5
Democracy Corps (D),6/23 - 6/27,2012,2012,1000 LV,47,48,-1
NBC News/Wall St. Jrnl,6/20 - 6/24,2012,2012,1000 A,47,48,-1
Bloomberg,6/15 - 6/18,2012,2012,1002 A,53,44,9
Associated Press/GfK,6/14 - 6/18,2012,2012,1007 A,49,48,1
Pew Research,6/7 - 6/17,2012,2012,2013 A,47,45,2
Reuters/Ipsos,6/7 - 6/11,2012,2012,1099 A,47,50,-3
FOX News,6/3 - 6/5,2012,2012,907 RV,49,45,4
CNN/Opinion Research,5/29 - 5/31,2012,2012,895 RV,49,50,-1
National Journal,5/19 - 5/23,2012,2012,1000 A,47,48,-1
ABC News/Wash Post,5/17 - 5/20,2012,2012,1004 A,47,49,-2
NBC News/Wall St. Jrnl,5/16 - 5/20,2012,2012,1000 A,48,46,2
Pew Research,5/9 - 6/3,2012,2012,3003 A,46,42,4
FOX News,5/13 - 5/15,2012,2012,913 RV,49,47,2
Reuters/Ipsos,5/3 - 5/7,2012,2012,1131 A,50,47,3
Associated Press/GfK,5/3 - 5/7,2012,2012,1004 A,53,46,7
Resurgent Republic (R),4/30 - 5/3,2012,2012,1000 RV,50,46,4
Politico/GWU/Battleground,4/29 - 5/3,2012,2012,1000 LV,48,48,-
Democracy Corps (D),4/28 - 5/1,2012,2012,1000 LV,45,50,-5
FOX News,4/22 - 4/24,2012,2012,915 RV,45,51,-6
NBC News/Wall St. Jrnl,4/13 - 4/17,2012,2012,1000 A,49,46,3
CBS News/NY Times,4/13 - 4/17,2012,2012,957 A,48,42,6
Quinnipiac,4/11 - 4/17,2012,2012,2577 RV,47,48,-1
Reuters/Ipsos,4/12 - 4/15,2012,2012,1044 A,49,49,-
CNN/Opinion Research,4/13 - 4/15,2012,2012,1015 A,49,48,1
Pew Research,4/4 - 4/15,2012,2012,1514 A,46,45,1
FOX News,4/9 - 4/11,2012,2012,910 RV,42,51,-9
ABC News/Wash Post,4/5 - 4/8,2012,2012,1103 A,50,45,5
CNN/Opinion Research,3/24 - 3/25,2012,2012,1014 A,51,45,6
McClatchy/Marist,3/20 - 3/22,2012,2012,846 RV,48,47,1
Reason-Rupe,3/10 - 3/20,2012,2012,1200 A,48,46,2
FOX News,3/10 - 3/12,2012,2012,912 RV,47,45,2
Bloomberg,3/8 - 3/11,2012,2012,1002 A,48,47,1
Reuters/Ipsos,3/8 - 3/11,2012,2012,1084 A,50,48,2
CBS News/NY Times,3/7 - 3/11,2012,2012,1009 A,41,47,-6
Pew Research,3/7 - 3/11,2012,2012,1503 A,50,41,9
ABC News/Wash Post,3/7 - 3/10,2012,2012,1003 A,46,50,-4
National Journal,3/3 - 3/6,2012,2012,1000 A,51,45,6
NBC News/Wall St. Jrnl,2/29 - 3/3,2012,2012,800 A,50,45,5
Politico/GWU/Battleground,2/19 - 2/22,2012,2012,1000 LV,53,45,8
Associated Press/GfK,2/16 - 2/20,2012,2012,1000 A,49,49,-
Quinnipiac,2/14 - 2/20,2012,2012,2605 RV,45,49,-4
Democracy Corps (D),2/11 - 2/14,2012,2012,1000 LV,50,46,4
CNN/Opinion Research,2/10 - 2/13,2012,2012,1026 A,50,48,2
CBS News/NY Times,2/8 - 2/13,2012,2012,1197 A,50,43,7
Pew Research,2/8 - 2/12,2012,2012,1501 A,47,43,4
FOX News,2/6 - 2/9,2012,2012,1110 RV,48,45,3
Reuters/Ipsos,2/2 - 2/6,2012,2012,1033 A,48,49,-1
ABC News/Wash Post,2/1 - 2/4,2012,2012,1000 A,50,46,4
NBC News/Wall St. Jrnl,1/22 - 1/24,2012,2012,1000 A,48,46,2
CBS News/NY Times,1/12 - 1/17,2012,2012,1154 A,47,45,2
Pew Research,1/11 - 1/16,2012,2012,1502 A,44,48,-4
ABC News/Wash Post,1/12 - 1/15,2012,2012,1000 A,48,48,-
FOX News,1/12 - 1/14,2012,2012,906 RV,45,47,-2
CNN/Opinion Research,1/11 - 1/12,2012,2012,1021 A,47,51,-4
Democracy Corps (D),1/8 - 1/11,2012,2012,1000 LV,44,49,-5
Reuters/Ipsos,1/5 - 1/9,2012,2012,1046 A,47,49,-2
CBS News,1/4 - 1/8,2012,2012,1413 A,45,47,-2
CNN/Opinion Research,12/16 - 12/18,2011,2011,1015 A,49,48,1
ABC News/Wash Post,12/15 - 12/18,2011,2011,1005 A,49,47,2
CBS News,12/14 - 12/18,2011,2011,992 A,47,44,3
Associated Press/GfK,12/8 - 12/12,2011,2011,1000 A,44,54,-10
Reuters/Ipsos,12/8 - 12/12,2011,2011,1102 A,47,48,-1
NBC News/Wall St. Jrnl,12/7 - 12/11,2011,2011,1000 A,46,48,-2
Pew Research,12/7 - 12/11,2011,2011,1521 A,46,43,3
CBS News,12/5 - 12/7,2011,2011,856 A,44,46,-2
FOX News,12/5 - 12/7,2011,2011,911 RV,44,51,-7
National Journal/FD,11/30 - 12/4,2011,2011,1200 A,44,49,-5
CNN/Opinion Research,11/18 - 11/20,2011,2011,1019 A,44,54,-10
Quinnipiac,11/14 - 11/20,2011,2011,2552 RV,44,50,-6
FOX News,11/13 - 11/15,2011,2011,914 RV,42,48,-6
CNN/Opinion Research,11/11 - 11/13,2011,2011,1036 A,46,52,-6
Pew Research,11/9 - 11/14,2011,2011,2001 A,46,46,-
McClatchy/Marist,11/8 - 11/10,2011,2011,872 RV,43,50,-7
CBS News,11/6 - 11/10,2011,2011,1182 A,43,47,-4
Politico/GWU/Battleground,11/6 - 11/9,2011,2011,1000 LV,44,51,-7
NBC News/Wall St. Jrnl,11/2 - 11/5,2011,2011,1000 A,44,51,-7
ABC News/Wash Post,10/31 - 11/3,2011,2011,1004 A,44,53,-9
Reuters/Ipsos,10/31 - 11/3,2011,2011,1106 A,49,50,-1
Resurgent Republic (R),10/30 - 11/2,2011,2011,1000 RV,50,47,3
Quinnipiac,10/25 - 10/31,2011,2011,2294 RV,47,49,-2
FOX News,10/23 - 10/25,2011,2011,904 RV,43,50,-7
CBS News/NY Times,10/19 - 10/24,2011,2011,1650 A,46,46,-
Democracy Corps (D),10/15 - 10/18,2011,2011,1000 LV,40,53,-13
CNN/Opinion Research,10/14 - 10/16,2011,2011,1007 A,46,50,-4
Associated Press/GfK,10/13 - 10/17,2011,2011,1000 A,46,52,-6
Time,10/9 - 10/10,2011,2011,1001 A,44,50,-6
NBC News/Wall St. Jrnl,10/6 - 10/10,2011,2011,1000 A,44,51,-7
Reuters/Ipsos,10/6 - 10/10,2011,2011,1113 A,47,50,-3
ABC News/Wash Post,9/29 - 10/2,2011,2011,1002 A,42,54,-12
National Journal/FD,9/28 - 10/2,2011,2011,1000 A,44,50,-6
CBS News,9/28 - 10/2,2011,2011,1012 A,44,44,-
Quinnipiac,9/27 - 10/3,2011,2011,2118 RV,41,55,-14
Pew Research,9/22 - 10/4,2011,2011,2410 A,43,48,-5
FOX News,9/25 - 9/27,2011,2011,925 RV,43,51,-8
CNN/Opinion Research,9/23 - 9/25,2011,2011,1010 A,45,52,-7
McClatchy/Marist,9/13 - 9/14,2011,2011,825 RV,39,52,-13
CBS News/NY Times,9/10 - 9/15,2011,2011,1452 A,43,50,-7
Bloomberg,9/9 - 9/12,2011,2011,997 A,45,49,-4
CNN/Opinion Research,9/9 - 9/11,2011,2011,1038 A,43,55,-12
Reuters/Ipsos,9/8 - 9/12,2011,2011,1134 A,47,48,-1
ABC News/Wash Post,8/29 - 9/1,2011,2011,1001 A,43,53,-10
Politico/GWU/Battleground,8/28 - 9/1,2011,2011,1000 LV,45,50,-5
FOX News,8/29 - 8/31,2011,2011,911 RV,44,47,-3
Resurgent Republic (R),8/28 - 8/31,2011,2011,1000 RV,47,50,-3
NBC News/Wall St. Jrnl,8/27 - 8/31,2011,2011,1000 A,44,51,-7
Quinnipiac,8/16 - 8/27,2011,2011,2730 RV,42,52,-10
CNN/Opinion Research,8/24 - 8/25,2011,2011,1017 A,45,54,-9
Associated Press/GfK,8/18 - 8/22,2011,2011,1000 A,46,52,-6
Pew Research,8/17 - 8/21,2011,2011,1509 A,43,49,-6
Democracy Corps (D),8/6 - 8/10,2011,2011,1000 LV,45,50,-5
Washington Post,8/9 - 8/9,2011,2011,601 A,44,46,-2
FOX News,8/7 - 8/9,2011,2011,904 RV,42,48,-6
Reuters/Ipsos,8/4 - 8/8,2011,2011,1055 A,45,52,-7
CNN/Opinion Research,8/5 - 8/7,2011,2011,1008 A,44,54,-10
McClatchy/Marist,8/2 - 8/4,2011,2011,807 RV,44,46,-2
CNN/Opinion Research,8/1 - 8/1,2011,2011,860 A,45,52,-7
Pew Research,7/20 - 7/24,2011,2011,1501 A,44,48,-4
CNN/Opinion Research,7/18 - 7/20,2011,2011,1009 A,45,54,-9
FOX News,7/17 - 7/19,2011,2011,904 RV,45,46,-1
USA Today/Gallup,7/15 - 7/17,2011,2011,1016 A,45,50,-5
NBC News/Wall St. Jrnl,7/14 - 7/17,2011,2011,1000 A,47,48,-1
ABC News/Wash Post,7/14 - 7/17,2011,2011,1001 A,47,48,-1
Reuters/Ipsos,7/8 - 7/11,2011,2011,1173 A,49,46,3
Quinnipiac,7/5 - 7/11,2011,2011,2311 RV,47,46,1
FOX News,6/26 - 6/28,2011,2011,912 RV,46,46,-
CBS News/NY Times,6/24 - 6/28,2011,2011,979 A,47,44,3
McClatchy/Marist,6/15 - 6/23,2011,2011,801 RV,45,47,-2
Time,6/20 - 6/21,2011,2011,1003 A,48,46,2
Democracy Corps (D),6/18 - 6/21,2011,2011,1000 RV,46,48,-2
Bloomberg,6/17 - 6/20,2011,2011,1000 A,49,44,5
Associated Press/GfK,6/16 - 6/20,2011,2011,1001 A,52,47,5
Pew Research,6/15 - 6/19,2011,2011,1502 A,46,45,1
NBC News/Wall St. Jrnl,6/9 - 6/13,2011,2011,1000 A,49,46,3
FOX News,6/5 - 6/7,2011,2011,912 RV,48,43,5
CBS News,6/3 - 6/7,2011,2011,1024 A,48,43,5
CNN/Opinion Research,6/3 - 6/7,2011,2011,1015 A,48,48,-
Reuters/Ipsos,6/3 - 6/6,2011,2011,1132 A,50,46,4
Quinnipiac,5/31 - 6/6,2011,2011,1946 RV,47,46,1
ABC News/Wash Post,6/2 - 6/5,2011,2011,1002 A,47,49,-2
Pew Research,5/25 - 5/30,2011,2011,1509 A,52,39,13
CNN/Opinion Research,5/24 - 5/26,2011,2011,1007 A,54,45,9
Democracy Corps (D),5/21 - 5/25,2011,2011,1000 LV,49,45,4
National Journal/FD,5/18 - 5/22,2011,2011,1000 A,51,41,10
FOX News,5/15 - 5/17,2011,2011,910 RV,55,41,14
Politico/GWU/Battleground,5/8 - 5/12,2011,2011,1000 LV,52,44,8
Reuters/Ipsos,5/5 - 5/9,2011,2011,1029 A,49,47,2
Associated Press/GfK,5/5 - 5/9,2011,2011,1001 A,60,39,21
Pew Research,5/5 - 5/8,2011,2011,1003 A,50,39,11
NBC News,5/5 - 5/7,2011,2011,800 A,52,41,11
Quinnipiac,5/2 - 5/3,2011,2011,834 RV,52,40,12
Newsweek/Daily Beast,5/2 - 5/3,2011,2011,600 A,48,49,-1
CBS News/NY Times*,5/2 - 5/3,2011,2011,532 A,57,37,20
CNN/Opinion Research,5/2 - 5/2,2011,2011,700 A,52,43,9
SurveyUSA,5/2 - 5/2,2011,2011,1000 A,46,42,4
Wash Post/Pew/SRBI,5/2 - 5/2,2011,2011,654 A,56,38,18
Newsweek/Daily Beast,4/30 - 5/1,2011,2011,600 A,48,49,-1
CNN/Opinion Research,4/29 - 5/1,2011,2011,A,51,46,5
Quinnipiac,4/26 - 5/1,2011,2011,1409 RV,46,48,-2
FOX News,4/25 - 4/27,2011,2011,911 RV,47,47,-
CBS News/NY Times,4/15 - 4/20,2011,2011,1224 A,46,45,1
ABC News/Wash Post,4/14 - 4/17,2011,2011,1001 A,47,50,-3
McClatchy/Marist,4/10 - 4/14,2011,2011,1084 RV,44,49,-5
Democracy Corps (D),4/10 - 4/12,2011,2011,1000 LV,44,50,-6
CNN/Opinion Research,4/9 - 4/10,2011,2011,824 A,48,50,-2
Reuters/Ipsos,4/7 - 4/10,2011,2011,1042 A,46,49,-3
FOX News,4/3 - 4/5,2011,2011,914 RV,49,47,2
NBC News/Wall St. Jrnl,3/31 - 4/4,2011,2011,1000 A,49,45,4
Pew Research,3/30 - 4/3,2011,2011,1507 A,47,45,2
Associated Press/GfK,3/24 - 3/28,2011,2011,1001 A,53,45,8
Quinnipiac,3/22 - 3/28,2011,2011,2069 RV,42,48,-6
FDU/Public Mind,3/21 - 3/28,2011,2011,800 RV,44,48,-4
CBS News,3/18 - 3/21,2011,2011,1022 A,49,41,8
CNN,3/18 - 3/20,2011,2011,1012 A,51,47,4
FOX News,3/14 - 3/16,2011,2011,913 RV,49,44,5
CNN,3/11 - 3/13,2011,2011,1023 A,50,47,3
ABC News/Wash Post,3/10 - 3/13,2011,2011,1005 A,51,45,6
National Journal/FD,3/4 - 3/8,2011,2011,1000 A,49,44,5
Bloomberg,3/4 - 3/7,2011,2011,1001 A,51,43,8
Reuters/Ipsos,3/3 - 3/6,2011,2011,1040 A,49,47,2
Resurgent Republic (R),3/1 - 3/3,2011,2011,1000 RV,47,49,-2
NBC News/Wall St. Jrnl,2/24 - 2/28,2011,2011,1000 A,48,46,2
Pew Research,2/22 - 3/1,2011,2011,1504 A,51,39,12
Quinnipiac,2/21 - 2/28,2011,2011,1887 RV,46,46,-
Newsweek/Daily Beast,2/12 - 2/15,2011,2011,918 LV,50,44,6
CBS News,2/11 - 2/14,2011,2011,1031 A,48,41,7
Democracy Corps (D),2/7 - 2/9,2011,2011,1000 LV,51,44,7
FOX News,2/7 - 2/9,2011,2011,911 RV,51,43,8
Reuters/Ipsos,2/4 - 2/7,2011,2011,1112 A,51,46,5
Pew Research,2/2 - 2/7,2011,2011,1385 A,49,42,7
CNN/Opinion Research,1/21 - 1/23,2011,2011,1012 A,55,44,11
FOX News,1/18 - 1/19,2011,2011,900 RV,47,44,3
CBS News/NY Times,1/15 - 1/19,2011,2011,1036 A,49,39,10
NBC News/Wall St. Jrnl,1/13 - 1/17,2011,2011,1000 A,53,41,12
CNN/Opinion Research,1/14 - 1/16,2011,2011,1014 A,53,45,8
ABC News/Wash Post,1/13 - 1/16,2011,2011,1053 A,54,43,11
Democracy Corps (D),1/9 - 1/12,2011,2011,1000 LV,47,47,-
Reuters/Ipsos,1/7 - 1/10,2011,2011,1021 A,50,47,3
McClatchy/Marist,1/6 - 1/10,2011,2011,827 RV,48,43,5
Quinnipiac,1/4 - 1/11,2011,2011,1647 RV,48,44,4
Associated Press/GfK,1/5 - 1/10,2011,2011,1001 A,53,46,7
Pew Research,1/5 - 1/9,2011,2011,1503 A,46,44,2
CNN/Opinion Research,12/17 - 12/19,2010,2010,1008 A,48,48,-
FOX News,12/14 - 12/15,2010,2010,900 RV,40,51,-11
NBC News/Wall St. Jrnl,12/9 - 12/13,2010,2010,1000 A,45,48,-3
ABC News/Wash Post,12/9 - 12/12,2010,2010,1001 A,49,47,2
McClatchy/Marist,12/2 - 12/8,2010,2010,873 RV,42,50,-8
Bloomberg,12/4 - 12/7,2010,2010,1000 A,47,48,-1
Reuters/Ipsos,12/2 - 12/5,2010,2010,1028 A,45,46,-1
Pew Research,12/1 - 12/5,2010,2010,1500 A,45,43,2
CBS News,11/29 - 12/2,2010,2010,1067 A,48,42,6
National Journal/FD,11/29 - 12/1,2010,2010,1200 A,48,46,2
USA Today/Gallup,11/19 - 11/21,2010,2010,1037 A,42,54,-12
Associated Press/CNBC,11/18 - 11/22,2010,2010,1000 A,48,48,-
McClatchy/Marist,11/15 - 11/18,2010,2010,810 RV,45,48,-3
NBC News/Wall St. Jrnl,11/11 - 11/15,2010,2010,1000 A,47,47,-
CNN/Opinion Research,11/11 - 11/14,2010,2010,1014 A,48,50,-2
Quinnipiac,11/8 - 11/15,2010,2010,2424 RV,44,49,-5
CBS News,11/7 - 11/10,2010,2010,1137 A,45,45,-
Pew Research,11/4 - 11/7,2010,2010,1255 A,44,44,-
Associated Press/GfK,11/3 - 11/8,2010,2010,1000 A,47,51,-4
Reuters/Ipsos,10/28 - 10/31,2010,2010,1075 A,45,51,-6
NBC News/Wall St. Jrnl,10/28 - 10/30,2010,2010,1000 RV,45,50,-5
CNN/Opinion Research,10/27 - 10/30,2010,2010,1006 A,46,51,-5
FOX News,10/26 - 10/28,2010,2010,1200 RV,41,50,-9
ABC News/Wash Post,10/25 - 10/28,2010,2010,1202 A,50,45,5
CBS News/NY Times,10/21 - 10/26,2010,2010,1173 A,45,47,-2
McClatchy/Marist,10/22 - 10/25,2010,2010,807 RV,48,43,5
Schoen,10/18 - 10/24,2010,2010,1000 LV,42,57,-15
Newsweek*,10/20 - 10/21,2010,2010,1005 A,54,40,14
Politico/GWU/Battleground,10/17 - 10/20,2010,2010,1000 LV,46,51,-5
NBC News/Wall St. Jrnl,10/14 - 10/18,2010,2010,1000 RV,47,49,-2
Pew Research,10/13 - 10/18,2010,2010,2251 A,46,45,1
Associated Press/GfK,10/13 - 10/18,2010,2010,1501 A,49,50,-1
FOX News,10/11 - 10/13,2010,2010,1200 RV,43,47,-4
Reuters/Ipsos,10/7 - 10/11,2010,2010,1038 A,43,53,-10
Bloomberg,10/7 - 10/10,2010,2010,721 LV,47,48,-1
CNN/Opinion Research,10/5 - 10/7,2010,2010,1008 A,45,52,-7
CBS News,10/1 - 10/5,2010,2010,1129 A,44,45,-1
McClatchy/Marist,9/30 - 10/5,2010,2010,829 RV,43,50,-7
Democracy Corps (D),10/2 - 10/4,2010,2010,816 LV,42,52,-10
ABC News/Wash Post,9/30 - 10/3,2010,2010,1002 A,50,47,3
Newsweek,9/29 - 9/30,2010,2010,1025 A,48,46,2
FOX News,9/28 - 9/29,2010,2010,900 RV,42,49,-7
NBC News/Wall St. Jrnl,9/22 - 9/26,2010,2010,1000 A,46,49,-3
CNN/Opinion Research,9/21 - 9/23,2010,2010,1010 A,42,54,-12
Politico/GWU/Battleground,9/19 - 9/22,2010,2010,1000 LV,46,51,-5
Reuters/Ipsos,9/16 - 9/19,2010,2010,1161 A,47,50,-3
FOX News,9/14 - 9/16,2010,2010,900 RV,42,52,-10
McClatchy/Marist,9/14 - 9/16,2010,2010,815 RV,45,50,-5
Democracy Corps (D),9/11 - 9/14,2010,2010,1000 RV,49,47,2
CBS News/NY Times,9/10 - 9/14,2010,2010,990 A,45,47,-2
Associated Press/GfK,9/8 - 9/13,2010,2010,1000 A,49,50,-1
Politico/GWU/Battleground,9/7 - 9/9,2010,2010,1000 LV,45,48,-3
Quinnipiac,8/31 - 9/7,2010,2010,1905 RV,44,47,-3
Pew Research,8/25 - 9/6,2010,2010,3509 A,47,44,3
CNN/Opinion Research,9/1 - 9/2,2010,2010,1024 A,50,49,1
FOX News,9/1 - 9/2,2010,2010,900 RV,46,48,-2
ABC News/Wash Post,8/30 - 9/2,2010,2010,1002 A,46,52,-6
Democracy Corps (D),8/30 - 9/2,2010,2010,1000 RV,46,50,-4
USA Today/Gallup,8/27 - 8/30,2010,2010,1021 A,43,53,-10
National Journal/FD,8/27 - 8/30,2010,2010,1201 A,46,49,-3
NBC News/Wall St. Jrnl,8/26 - 8/30,2010,2010,1000 A,45,49,-4
Newsweek,8/25 - 8/26,2010,2010,1029 A,47,45,2
CBS News,8/20 - 8/24,2010,2010,1082 A,48,44,4
Reuters/Ipsos,8/19 - 8/22,2010,2010,1063 A,45,52,-7
Time,8/16 - 8/17,2010,2010,1002 A,46,45,1
Associated Press/GfK,8/11 - 8/16,2010,2010,1007 A,49,50,-1
FOX News,8/10 - 8/11,2010,2010,900 RV,43,49,-6
CNN/Opinion Research,8/6 - 8/10,2010,2010,1009 A,47,51,-4
NBC News/Wall St. Jrnl,8/5 - 8/9,2010,2010,1000 A,47,48,-1
USA Today/Gallup,7/27 - 8/1,2010,2010,1208 A,41,53,-12
Pew Research,7/21 - 8/5,2010,2010,3003 A,47,41,6
Democracy Corps (D),7/26 - 7/29,2010,2010,1000 RV,45,51,-6
FOX News,7/27 - 7/28,2010,2010,900 RV,43,50,-7
Reuters/Ipsos,7/22 - 7/25,2010,2010,1075 A,48,48,-
CNN/Opinion Research,7/16 - 7/21,2010,2010,1018 A,47,50,-3
Quinnipiac,7/13 - 7/19,2010,2010,2181 RV,44,48,-4
FOX News,7/13 - 7/14,2010,2010,900 RV,43,48,-5
Time,7/12 - 7/13,2010,2010,1003 A,49,45,4
CBS News,7/9 - 7/12,2010,2010,986 A,44,44,-
Bloomberg,7/9 - 7/12,2010,2010,1004 A,52,44,8
ABC News/Wash Post,7/7 - 7/11,2010,2010,1288 A,50,47,3
FOX News,6/29 - 6/30,2010,2010,900 RV,47,45,2
Newsweek,6/23 - 6/24,2010,2010,964 A,48,46,2
Resurgent Republic (R),6/20 - 6/23,2010,2010,1000 RV,49,48,1
Democracy Corps (D),6/19 - 6/22,2010,2010,1001 RV,46,50,-4
Marist,6/17 - 6/24,2010,2010,813 RV,44,45,-1
NBC News/Wall St. Jrnl,6/17 - 6/21,2010,2010,1000 A,45,48,-3
Pew Research,6/16 - 6/20,2010,2010,1802 A,48,43,5
CBS News/NY Times,6/16 - 6/20,2010,2010,1259 A,47,43,4
CNN/OpinionResearch,6/16 - 6/16,2010,2010,534 A,50,48,2
Ipsos/McClatchy,6/10 - 6/13,2010,2010,1071 A,50,45,5
Associated Press/GfK,6/9 - 6/14,2010,2010,1044 A,50,49,1
FOX News,6/8 - 6/9,2010,2010,900 RV,46,45,1
ABC News/Wash Post,6/3 - 6/6,2010,2010,1004 A,52,45,7
USA Today/Gallup,5/24 - 5/25,2010,2010,1049 A,48,48,-
CBS News,5/20 - 5/24,2010,2010,1054 A,47,43,4
Quinnipiac,5/19 - 5/24,2010,2010,1914 RV,48,43,5
CNN/Opinion Research,5/21 - 5/23,2010,2010,1023 A,51,46,5
NBC News,5/20 - 5/23,2010,2010,700 A,48,45,3
FOX News,5/18 - 5/19,2010,2010,900 RV,45,46,-1
Democracy Corps (D),5/15 - 5/18,2010,2010,1000 RV,47,47,-
Associated Press/GfK,5/7 - 5/11,2010,2010,1002 A,49,50,-1
NBC News/Wall St. Jrnl,5/6 - 5/10,2010,2010,1000 A,50,44,6
Ipsos/McClatchy,5/6 - 5/9,2010,2010,1016 A,52,43,9
Pew Research,5/6 - 5/9,2010,2010,994 A,47,42,5
FOX News,5/4 - 5/5,2010,2010,900 RV,48,43,5
CBS News/NY Times,4/28 - 5/2,2010,2010,1079 A,51,39,12
Resurgent Republic (R),4/25 - 4/27,2010,2010,1000 RV,48,48,-
National Journal/FD,4/22 - 4/26,2010,2010,1200 A,48,46,2
Pew Research,4/21 - 4/26,2010,2010,1546 A,47,42,5
ABC News/Wash Post,4/22 - 4/25,2010,2010,1001 A,54,44,10
FOX News,4/20 - 4/21,2010,2010,900 RV,46,46,-
Democracy Corps (D),4/17 - 4/20,2010,2010,1000 RV,48,46,2
Quinnipiac,4/14 - 4/19,2010,2010,1930 RV,44,46,-2
Associated Press/GfK,4/7 - 4/12,2010,2010,1001 A,49,50,-1
CNN/Opinion Research,4/9 - 4/11,2010,2010,1008 A,51,47,4
CBS News/NY Times,4/5 - 4/12,2010,2010,1580 A,50,40,10
FOX News,4/6 - 4/7,2010,2010,900 RV,43,48,-5
GWU/Battleground,4/5 - 4/8,2010,2010,1000 LV,50,47,3
Ipsos-McClatchy,4/1 - 4/5,2010,2010,1013 A,51,46,5
CBS News,3/29 - 4/1,2010,2010,858 A,44,41,3
USA Today/Gallup,3/26 - 3/28,2010,2010,1033 A,47,50,-3
Marist,3/25 - 3/29,2010,2010,860 RV,46,43,3
CNN/Opinion Research,3/25 - 3/28,2010,2010,935 RV,51,48,3
Washington Post,3/23 - 3/26,2010,2010,1000 A,53,43,10
Quinnipiac,3/22 - 3/23,2010,2010,1552 RV,45,46,-1
Bloomberg,3/19 - 3/22,2010,2010,1002 A,50,45,5
CNN/Opinion Research,3/19 - 3/21,2010,2010,953 RV,46,51,-5
CBS News,3/18 - 3/21,2010,2010,1059 A,49,41,8
Quinnipiac,3/16 - 3/21,2010,2010,1907 RV,46,49,-3
Democracy Corps (D),3/15 - 3/18,2010,2010,1016 RV,46,48,-2
FOX News,3/16 - 3/17,2010,2010,900 RV,46,48,-2
NBC News/Wall St. Jrnl,3/11 - 3/14,2010,2010,1000 A,48,47,1
Pew Research,3/10 - 3/14,2010,2010,1500 A,46,43,3
Associated Press/GfK,3/3 - 3/8,2010,2010,1002 A,53,46,7
Ipsos/McClatchy,2/26 - 2/28,2010,2010,1076 A,53,44,9
FOX News,2/23 - 2/24,2010,2010,900 RV,47,45,2
Democracy Corps (D),2/20 - 2/24,2010,2010,1001 RV,49,46,3
Zogby,7/31 - 8/4,2009,2009,1005 LV,53,38,15
POS (R),2/17 - 2/18,2010,2010,900 RV,48,48,-
CNN/Opinion Research*,7/31 - 8/3,2009,2009,1136 A,56,40,16
Newsweek,2/17 - 2/18,2010,2010,1009 A,48,40,8
Ipsos/McClatchy,7/30 - 8/3,2009,2009,1005 A,58,37,21
CNN/Opinion Research,2/12 - 2/15,2010,2010,1023 A,49,50,-1
Quinnipiac,7/27 - 8/3,2009,2009,2409 RV,50,42,8
CBS News/NY Times,2/5 - 2/10,2010,2010,1084 A,46,45,1
Time,7/27 - 7/28,2009,2009,1002 A,56,38,18
CBS News/NY Times,7/24 - 7/28,2009,2009,1050 A,58,30,28
Pew Research,2/3 - 2/9,2010,2010,1383 A,49,39,10
ABC News/Wash Post,2/4 - 2/8,2010,2010,1004 A,51,46,5
NBC News/Wall St. Jrnl,7/24 - 7/27,2009,2009,1011 A,53,40,13
Quinnipiac,2/2 - 2/8,2010,2010,2617 RV,45,46,-1
Democracy Corps (D),2/2 - 2/4,2010,2010,805 LV,47,47,-
Pew Research,7/22 - 7/26,2009,2009,1506 A,54,34,20
FOX News,2/2 - 2/3,2010,2010,900 RV,46,47,-1
NPR,7/22 - 7/26,2009,2009,850 LV,53,42,11
GWU/Battleground,7/19 - 7/23,2009,2009,1000 LV,53,42,11
Marist,2/1 - 2/3,2010,2010,910 RV,44,47,-3
Ipsos/McClatchy,1/28 - 1/31,2010,2010,1127 A,50,46,4
FOX News,7/21 - 7/22,2009,2009,900 RV,54,38,16
Associated Press/GfK,7/16 - 7/20,2009,2009,1006 A,55,42,13
USA Today/Gallup,7/17 - 7/19,2009,2009,1006 A,55,41,14
NBC News/Wall St. Jrnl,1/23 - 1/25,2010,2010,800 A,50,44,6
CNN/Opinion Research,1/22 - 1/24,2010,2010,1009 A,49,50,-1
NPR - POS/GQR,1/20 - 1/23,2010,2010,800 LV,49,48,1
ABC News/Wash Post,7/15 - 7/18,2009,2009,1001 A,59,37,22
CBS News,1/14 - 1/17,2010,2010,1090 A,50,40,10
Diageo/Hotline,7/9 - 7/13,2009,2009,800 RV,56,38,18
Associated Press/GfK,1/12 - 1/17,2010,2010,1008 A,56,42,14
Ipsos/McClatchy,7/9 - 7/13,2009,2009,1007 A,57,38,19
ABC News/Wash Post,1/12 - 1/15,2010,2010,1083 A,53,44,9
CBS News,7/9 - 7/12,2009,2009,944 A,57,32,25
National Journal/FD,7/5 - 7/12,2009,2009,1202 A,56,36,20
NBC News/Wall St. Jrnl,1/10 - 1/14,2010,2010,1002 A,48,43,5
FOX News,1/12 - 1/13,2010,2010,900 RV,50,42,8
Quinnipiac,6/23 - 6/29,2009,2009,3063 RV,57,33,24
CNN/Opinion Research,6/26 - 6/28,2009,2009,1026 A,61,37,24
Democracy Corps (D),1/7 - 1/11,2010,2010,1001 RV,50,46,4
Ipsos/McClatchy,1/7 - 1/11,2010,2010,1336 A,52,45,7
Democracy Corps (D),6/19 - 6/22,2009,2009,1000 RV,56,36,20
ABC News/Wash Post,6/18 - 6/21,2009,2009,1001 A,65,31,34
CNN/Opinion Research,1/8 - 1/10,2010,2010,1021 A,51,48,3
Quinnipiac,1/5 - 1/11,2010,2010,1767 RV,45,45,-
USA Today/Gallup,1/8 - 1/9,2010,2010,2014 A,50,45,5
CBS News/NY Times,6/12 - 6/16,2009,2009,895 A,63,26,37
NBC News/Wall St. Jrnl,6/12 - 6/15,2009,2009,1008 A,56,34,22
Pew Research,6/10 - 6/14,2009,2009,1502 A,61,30,31
CBS News,1/6 - 1/10,2010,2010,1216 A,46,41,5
FOX News,6/9 - 6/10,2009,2009,900 RV,62,31,31
Pew Research,1/6 - 1/10,2010,2010,1504 A,49,42,7
Ipsos/McClatchy,6/4 - 6/8,2009,2009,1023 A,64,32,32
National Journal/FD,1/3 - 1/7,2010,2010,1200 A,47,45,2
CNN/Opinion Research,12/16 - 12/20,2009,2009,1160 A,54,44,10
Diageo/Hotline,6/4 - 6/7,2009,2009,800 RV,65,31,34
Quinnipiac,12/15 - 12/20,2009,2009,1616 RV,46,43,3
Marist,6/1 - 6/3,2009,2009,1028 RV,56,32,24
NBC News/Wall St. Jrnl,12/11 - 12/14,2009,2009,1008 A,47,46,1
Associated Press/GfK,5/28 - 6/1,2009,2009,1000 A,64,32,32
Associated Press/GfK,12/10 - 12/14,2009,2009,1001 A,56,42,14
Democracy Corps (D),5/28 - 6/1,2009,2009,1013 RV,58,33,25
USA Today/Gallup,12/11 - 12/13,2009,2009,1025 A,49,46,3
Quinnipiac,5/26 - 6/1,2009,2009,3097 RV,59,31,28
ABC News/Wash Post,12/10 - 12/13,2009,2009,1003 A,50,46,4
USA Today/Gallup,5/29 - 5/31,2009,2009,1015 A,61,34,27
CNN/Opinion Research,5/14 - 5/17,2009,2009,1010 A,62,35,27
Pew Research,12/9 - 12/13,2009,2009,1504 A,49,40,9
FOX News,5/12 - 5/13,2009,2009,900 RV,60,30,30
Battleground,12/6 - 12/10,2009,2009,1000 LV,50,45,5
Democracy Corps (D),5/10 - 5/12,2009,2009,1000 RV,59,33,26
FOX News,12/8 - 12/9,2009,2009,900 RV,50,44,6
CBS News/NY Times,12/4 - 12/8,2009,2009,1031 A,50,39,11
CBS News,5/6 - 5/12,2009,2009,1874 A,63,26,37
Ipsos/McClatchy,4/30 - 5/3,2009,2009,1004 A,65,31,34
Bloomberg,12/3 - 12/7,2009,2009,1000 A,54,41,13
Quinnipiac,4/21 - 4/27,2009,2009,2041 RV,58,30,28
Marist,12/2 - 12/7,2009,2009,858 RV,46,44,2
Diageo/Hotline,4/23 - 4/26,2009,2009,800 RV,62,33,29
Ipsos/McClatchy,12/3 - 12/6,2009,2009,1120 A,49,49,-
NBC News/Wall St. Jrnl,4/23 - 4/26,2009,2009,1005 A,61,30,31
Quinnipiac,12/1 - 12/6,2009,2009,2313 RV,46,44,2
CNN/Opinion Research,12/2 - 12/3,2009,2009,1041 A,48,50,-2
CNN/Opinion Research,4/23 - 4/26,2009,2009,2019 A,63,33,30
CBS News/NY Times,4/22 - 4/26,2009,2009,973 A,68,23,45
USA Today/Gallup,11/20 - 11/22,2009,2009,1017 A,50,44,6
FOX News,11/17 - 11/18,2009,2009,900 RV,46,46,-
ABC News/Wash Post,4/21 - 4/24,2009,2009,1072 A,69,26,43
CBS News,11/13 - 11/16,2009,2009,1167 A,53,36,17
FOX News,4/22 - 4/23,2009,2009,900 RV,62,29,33
CNN/Opinion Research,11/13 - 11/15,2009,2009,1014 A,55,42,13
Marist,4/21 - 4/23,2009,2009,975 RV,55,31,24
Democracy Corps (D),11/12 - 11/16,2009,2009,1000 RV,50,44,6
Pew Research,4/14 - 4/21,2009,2009,1507 A,63,26,37
Quinnipiac,11/9 - 11/16,2009,2009,2518 RV,48,42,6
Associated Press/GfK,4/16 - 4/20,2009,2009,1000 A,64,30,34
ABC News/Wash Post,11/12 - 11/15,2009,2009,1001 A,56,42,14
National Journal/FD,4/8 - 4/14,2009,2009,1200 A,61,28,33
POS (R),11/9 - 11/11,2009,2009,700 RV,52,44,8
Cook/RT Strategies,4/8 - 4/11,2009,2009,833 RV,60,30,30
Ipsos/McClatchy,4/2 - 4/6,2009,2009,1138 A,63,33,30
CNN/Opinion Research,4/3 - 4/5,2009,2009,1023 A,66,30,36
Associated Press/GfK,11/5 - 11/9,2009,2009,1006 A,54,43,11
Pew Research,10/28 - 11/8,2009,2009,2000 A,51,36,15
CNN/Opinion Research,10/30 - 11/1,2009,2009,1018 A,54,45,9
CBS News/NY Times,4/1 - 4/5,2009,2009,998 A,66,24,42
Ipsos/McClatchy,10/29 - 11/1,2009,2009,1077 A,53,43,10
Pew Research,3/31 - 4/6,2009,2009,1506 A,61,26,35
Marist,4/1 - 4/3,2009,2009,928 RV,56,30,26
FOX News,10/27 - 10/28,2009,2009,900 RV,50,41,9
Newsweek,4/1 - 4/2,2009,2009,1003 A,61,27,34
NBC News/Wall St. Jrnl,10/22 - 10/25,2009,2009,1009 A,51,42,9
FOX News,3/31 - 4/1,2009,2009,900 RV,58,32,26
Quinnipiac,3/24 - 3/30,2009,2009,2326 RV,58,31,27
USA Today/Gallup,3/27 - 3/29,2009,2009,1007 A,64,30,34
USA Today/Gallup,10/16 - 10/19,2009,2009,1521 A,50,46,4
ABC News/Wash Post,3/26 - 3/29,2009,2009,1000 A,66,29,37
CNN/Opinion Research,10/16 - 10/18,2009,2009,1038 A,55,43,12
Diageo/Hotline,3/26 - 3/29,2009,2009,800 RV,63,31,32
ABC News/Wash Post,10/15 - 10/18,2009,2009,1004 A,57,40,17
FOX News,10/13 - 10/14,2009,2009,900 RV,49,45,4
Democracy Corps (D),3/25 - 3/29,2009,2009,1000 RV,58,34,24
Marist,10/7 - 10/12,2009,2009,913 RV,53,41,12
CBS News,3/20 - 3/22,2009,2009,949 A,64,20,44
Rasmussen,10/6 - 10/8,2009,2009,1500 A,49,50,-1
CBS News,10/5 - 10/8,2009,2009,829 A,56,34,22
CBS News,3/12 - 3/16,2009,2009,1142 A,62,24,38
CNN/Opinion Research,3/12 - 3/15,2009,2009,1019 A,64,34,30
Ipsos/McClatchy,10/1 - 10/5,2009,2009,1296 A,56,40,16
Associated Press/GfK,10/1 - 10/5,2009,2009,1003 A,56,39,17
NPR - POS/GQR,3/10 - 3/14,2009,2009,800 LV,59,35,24
Quinnipiac,9/29 - 10/5,2009,2009,2630 RV,50,41,9
Pew Research,3/9 - 3/12,2009,2009,1308 A,59,26,33
Pew Research,9/30 - 10/4,2009,2009,1500 A,52,36,16
Ipsos-McClatchy,3/5 - 3/9,2009,2009,1070 A,65,29,36
Newsweek,3/4 - 3/5,2009,2009,1203 A,58,26,32
FOX News,3/3 - 3/4,2009,2009,900 RV,63,26,37
Rasmussen,9/29 - 10/1,2009,2009,1500 A,48,51,-3
FOX News,9/29 - 9/30,2009,2009,900 RV,50,42,8
National Journal/FD,9/24 - 9/28,2009,2009,1200 A,52,40,12
CBS News/NY Times,9/19 - 9/23,2009,2009,1042 A,56,33,23
Diageo/Hotline,2/28 - 3/2,2009,2009,803 RV,67,27,40
Quinnipiac,2/25 - 3/2,2009,2009,2573 RV,59,25,34
NBC News/Wall St. Jrnl,9/17 - 9/20,2009,2009,1005 A,51,41,10
Cook/RT Strategies,2/27 - 3/1,2009,2009,880 RV,57,28,29
FOX News,9/15 - 9/16,2009,2009,900 RV,54,39,15
NBC News/Wall St. Jrnl,2/26 - 3/1,2009,2009,1007 A,60,26,34
ABC News/Wash Post,2/19 - 2/22,2009,2009,1001 A,68,25,43
CBS News/NY Times,2/18 - 2/22,2009,2009,1112 A,63,22,41
Democracy Corps (D),9/12 - 9/16,2009,2009,1200 RV,52,41,11
CNN/Opinion Research,2/18 - 2/19,2009,2009,1046 A,67,29,38
Pew Research,9/10 - 9/15,2009,2009,1006 A,55,33,22
FOX News,2/17 - 2/18,2009,2009,900 RV,60,26,34
USA Today/Gallup,9/11 - 9/13,2009,2009,1030 A,54,43,11
Associated Press/GfK,2/12 - 2/17,2009,2009,1001 A,67,24,43
CNN/Opinion Research,9/11 - 9/13,2009,2009,1012 A,58,40,18
Bloomberg,9/10 - 9/14,2009,2009,1004 A,56,37,19
ABC News/Wash Post,9/10 - 9/12,2009,2009,1007 A,54,43,11
Democracy Corps (D),2/9 - 2/10,2009,2009,1000 LV,58,27,31
Associated Press/GfK,9/3 - 9/8,2009,2009,1001 A,50,49,1
Ipsos/McClatchy,2/6 - 2/9,2009,2009,1042 A,69,26,43
CNN,2/7 - 2/8,2009,2009,806 A,76,23,53
Pew Research,2/4 - 2/8,2009,2009,1303 A,64,17,47
Democracy Corps (D),8/29 - 9/1,2009,2009,1000 RV,51,42,9
CNN/Opinion Research,8/28 - 8/31,2009,2009,1010 A,53,45,8
Rasmussen,2/3 - 2/5,2009,2009,1500 LV,61,36,25
Ipsos-McClatchy,8/27 - 8/31,2009,2009,903 RV,56,40,16
CBS News,2/2 - 2/4,2009,2009,864 A,62,15,47
CBS News,8/27 - 8/31,2009,2009,1097 A,56,35,21
Pew Research,8/20 - 8/27,2009,2009,2003 A,52,37,15
Democracy Corps (D),1/26 - 1/29,2009,2009,1000 LV,55,20,35
FOX News,1/27 - 1/28,2009,2009,900 RV,65,16,49
NBC News,8/15 - 8/17,2009,2009,805 A,51,40,11
Rasmussen,1/25 - 1/27,2009,2009,1500 LV,62,36,26
ABC News/Wash Post,8/13 - 8/17,2009,2009,1001 A,57,40,17
Hotline/FD,1/21 - 1/24,2009,2009,800 RV,63,9,54
Pew Research,8/11 - 8/17,2009,2009,2010 A,51,37,14
FOX News,8/11 - 8/12,2009,2009,900 RV,53,40,13
Marist,8/3 - 8/6,2009,2009,845 RV,55,35,20
Rasmussen Reports*,5/10 - 5/10,2009,2009,1000 LV,49,44,5
PPP (D),6/4 - 6/7,2009,2009,650 RV,43,41,2
FOX News,9/14 - 9/16,2009,2009,900 RV,42,52,-10
Reuters/Ipsos,7/8 - 7/11,2009,2009,1173 A,49,46,3
CBS News/NY Times,5/11 - 5/13,2009,2009,615 A,50,48,2
Reuters/Ipsos,3/1 - 3/5,2009,2009,1797 A,43,51,-8
Reuters/Ipsos,3/9 - 3/12,2009,2009,1158 A,47,50,-3
Reuters/Ipsos,4/5 - 4/9,2009,2009,1457 A,46,48,-2
Reuters/Ipsos,4/12 - 4/16,2009,2009,2016 A,43,51,-8
Reuters/Ipsos,4/19 - 4/23,2009,2009,734 A,44,51,-7
The Economist/YouGov,4/20 - 4/22,2009,2009,673 RV,52,47,5
The Economist/YouGov,4/13 - 4/15,2009,2009,647 RV,46,51,-5
The Economist/YouGov,4/6 - 4/8,2009,2009,602 RV,48,50,-2
The Economist/YouGov,3/30 - 4/1,2009,2009,644 RV,50,49,1
The Economist/YouGov,3/23 - 3/25,2009,2009,652 RV,47,51,-4
The Economist/YouGov,3/16 - 3/18,2009,2009,646 RV,46,49,-3
The Economist/YouGov,3/9 - 3/11,2009,2009,665 RV,44,53,-9
The Economist/YouGov,3/2 - 3/4,2009,2009,667 RV,49,49,-
The Economist/YouGov,2/23 - 2/25,2009,2009,666 RV,48,47,1
The Economist/YouGov,2/16 - 2/18,2009,2009,637 RV,49,49,-
The Economist/YouGov,2/2 - 2/4,2009,2009,623 RV,48,50,-2
The Economist/YouGov,2/9 - 2/11,2009,2009,RV,47,50,-3
The Economist/YouGov,1/26 - 1/28,2009,2009,655 RV,49,48,1
The Economist/YouGov,1/20 - 1/22,2009,2009,RV,45,52,-7
The Economist/YouGov,1/10 - 1/12,2009,2009,RV,44,54,-10